en	hi
a bunch of books on book stand	पुस्तक स्टैंड पर पुस्तकों का एक गुच्छा
gold religious cross on top of golden ball	स्वर्ण गेंद के शीर्ष पर स्वर्ण धार्मिक क्रॉस
Candle on glass candle stand	कांच के मोमबत्ती स्टैंड पर मोमबत्ती
a blue wall beside tennis court	टेनिस कोर्ट के बगल में एक नीली दीवार
fine thin red hair	सूक्ष्म पतले लाल बाल
front springs of motocross motorcycle	मोटोक्रॉस मोटरसाइकिल के सामने स्प्रिंग्स
the tennis court is made up of sand and dirt	य़ह टेनिस कोर्ट रेत और धूल से बना है
court attendant sitting in chair	कुर्सी पर बैठे क़ोर्ट ऍटेंन्डेंट
a cross on the top of a spire	एक शिखर के शीर्ष पर एक क्रॉस
the cross is black	क्रॉस काला है
press box on tennis court	टेनिस कोर्ट पर प्रेस बॉक्स
the characters are chinese	य़ह पात्र चीनी हैं
date and time of photo	फोटो की तारीख और समय
Luggage sign in english and spanish	सामान का चिह्न अंग्रेजी और स्पेनिश में
box springs on bottom of bed	बिस्तर के तल पर बॉक्स स्प्रिंग्स
box springs with flower print	फूल के प्रिंट के साथ बॉक्स स्प्रिंग्स
fork under english muffin	अंग्रेजी मफिन के नीचे कांटा
there are two players in the court	क़ोर्ट में दो खिलाड़ी हैं
a man trying to cross	पार करने की कोशिश कर रहा एक आदमी
people on the second level	दूसरे स्तर पर लोग
Name and date stamp on picture	तस्वीर पर नाम और तारीख की मोहर
A stand of trees.	पेड़ों का एक झाड़।
umbrella to block sun	सूरज को अवरुद्ध करने के लिए छाता
the woman is waiting to cross the street	एक महिला सड़क पार करने के लिए इंतजार कर रही है
the lady appears to be going cross country skiing	महिला क्रॉस कंट्री स्कीइंग करती दिख रही है
White candle on a stand	एक स्टैंड पर सफेद मोमबत्ती
A grey rock wall forms a boundary of the enclosure	एक ग्रे पत्थ क़ी दीवार बाड़े की एक सीमा बनाती हुई
a large block entrance	एक बड़ा ब्लॉक प्रवेश द्वार
date when taken in yellow	पीले रंग में लिया गया
tail of cat forms a C	बिल्ली की पूंछ एक सी बनाती हुई
Wooden railing on second level	दूसरे स्तर पर लकड़ी की रेलिंग
white springs boxes and gears below train engine	सफेद स्प्रिंग्स बक्से और ट्रेन इंजन के नीचे गियर
time and date stamp on the photograph	तस्वीर पर समय और तारीख की मुहर
yellow fair pole on fence	बाड़ पर पीला निष्पक्ष पोल
baseball players dressed in gray and orange	ग्रे और नारंगी रंग के कपड़े पहने हुए बेसबॉल खिलाड़ी
teal sign with white asian characters	सफेद एशियाई पात्रों के साथ चैती साइन
Chain-link enclosure for tennis court	टेनिस कोर्ट के लिए चेन-लिंक संलग्नक
stand in the room	कमरे में खड़े हो जाओ
The window on the right on the second floor.	दूसरी मंजिल पर दाईं ओर की खिड़की।
Date stamp of photograph	फोटोग्राफ की तारीख का मोहर
large silver juice press	बड़े चांदी का रस प्रेस
the players in the dugout	डगआउट में खिलाड़ी
A white pot on the stand	स्टैंड पर एक सफेद मटका
Photo's date stamp.	फोटो की तारीख मोहर
hind leg forms one quadrant	पिछ्ला पैर एक चतुर्थांश बनाता है
Light green tennis court	हल्का हरा टेनिस कोर्ट
soccer players red shirt	फुटबॉल खिलाड़ी की लाल शर्ट
Gray television on stand	स्टैंड पर ग्रे टेलीविजन
a second meal plate.	भोजन की एक दूसरी थाली।
dark wooden wash stand	ग़ाढे रंग की लकड़ी का वाश स्टैंड
Cube-like cement block out-building with large square door	बड़े वर्ग द्वार के साथ घन-जैसा सीमेंट ब्लॉक ईमारत के बाहर
chinese characters on a red vehicle	एक लाल वाहन पर चीनी पात्र
blue tennis court area	नीला टेनिस कोर्ट क्षेत्र
Cement block outdoor flooring.	आउटडोर सीमेंट ब्लॉक फर्श।
the sign has asian characters	साइन में एशियाई वर्ण हैं
a cross sign on top of the tower	टॉवर के शीर्ष पर एक क्रॉस साइन
man is waiting to cross	आदमी पार होने की प्रतीक्षा कर रहा है
spikes on a players shoe	एक खिलाड़ी के जूते पर क़ीलें
a museum containing models of airplanes	एक संग्रहालय जिसमें हवाई जहाज़ों के मॉडलें हैं
date and time stamp on a picture	एक तस्वीर पर तारीख और समय की मुहर
Chinese characters on sign	चिन्ह पर चीनी अक्षर
an orange sign with written characters	लिखित अक्षरों के साथ एक नारंगी चिन्ह
Baseball players are in the background	बेसबॉल खिलाड़ी पृष्ठभूमि में हैं
Newspaper stand on the grass	अखबार स्टैंड घास पर हैं
young female date wearing a purple rhinestone sleeveless gown	एक बैंगनी स्फटिक स्लीवलेस गाउन पहनी हुई युवती
two people waiting to cross	पार करने हेतु इंतजार कर रहे दो लोग
the side of the second train	दूसरी ट्रेन का किनारा
the bird is stand on a tree branch	पक्षी एक पेड़ की शाखा पर खड़ा है
a black cross on a vertical stabilizer	एक ऊर्ध्वाधर स्टेबलाइजर पर एक काला क्रॉस
a green tennis court	एक हरी टेनिस कोर्ट
neutral makeup on both rain models	दोनों वर्षा मॉडलों पर तटस्थ मेकअप
the second bus has a blue sign	दूसरी बस में एक नीला चिन्ह है
This is some type of a fair.	यह किसी प्रकार का मेला है।
A display of different phone models	विभिन्न फोन मॉडलों का प्रदर्शन
microphone on the court	कोर्ट पर माइक्रोफोन
person doing a hand stand	व्यक्ति हाथों के बल खड़ा हुआ
springs of the seat	आसन की स्प्रिंग्स
A large pipe extending from the wall of the court.	कोर्ट की दीवार से निक्ली हुई एक बड़ी पाइप
rapid in fast water	तेजी से पानी में
a stone block train platform	एक पत्थर ब्लॉक का ट्रेन प्लेटफार्म
a book is on the night stand	नाइट स्टैंड पर एक किताब है
orange springs on the bottom of train	ट्रेन के तल पर नारंगी स्प्रिंग्स
a fast flowing river	एक तेज बहने वाली नदी
lighted signs for different forms of public transportation	सार्वजनिक परिवहन के विभिन्न रूपों के लिए रोशन संकेत
three windows on the second floor	दूसरी मंजिल पर तीन खिड़कियां
a dark blue sedan moving fast	एक गहरा नीला सेडान तेजी से बढ़ रहा है
zebras stand close together to watch for predators	ज़ेबरा शिकारियों को देखने के लिए एक साथ खड़े होते हैं
Gated street fair	गेटेड स्ट्रीट फेयर
surfboard forms a splash of water	सर्फ़बोर्ड पानी के छींटे बनाता है
paper triangle stand	कागज़ी त्रिकोण स्टैंड
a time and date stamp	एक समय और तारीख क़ी मोहर
english letter is white	अंग्रेजी अक्षर सफेद है
Brown box is on the tennis court	भूरा बॉक्स टेनिस कोर्ट पर है
a cross is on the tower	मीनार पर एक क्रॉस है
players in dirt circle	मिट्टी के वृत्त में खिलाड़ी
beige stair way going to second level	बेज सीढ़ी दूसरे स्तर तक़ जा रही है
grey concrete cross by the building	इमारत के बगल में ग्रे कांक्रीट क्रॉस
block for bench feet	बेंच के पैरों के लिए ब्लॉक
location characters are white	स्थान वर्ण सफेद हैं
Brown plastic fast food table	ब्राउन प्लास्टिक फास्ट फूड टेबल
The TV and stand in the living room	लिविंग रूम में टीवी और स्टैड
brown wooden stairs leading to second floor	दूसरी मंजिल तक जाने वाली भूरे रंग की लकड़ी की सीढ़ियाँ
very fine fabric and material	बहु उत्तम कपड़े और सामग्री
do not block intersection sign is above the right lane must turn right sign	चौराहे को ब्लॉक न करें सन्केत के ऊपर दाईं लेन को दाहिनी ओर मुड़ना चाहिए सन्केत है
The motorcycles are going fast	मोटरसाइकिलें तेजी से जा रही हैं
a fence behind the players	खिलाड़ियों के पीछे एक बाड़
the date on the photo	तस्वीर पर तारीख
the penalty box is white lined	सफेद लाइन से सीमांकित जुर्माना बॉक्स
the green sign with red and yellow characters	लाल और पीले वर्णों के साथ हरे रंग का चिह्न
A red metal frame forms the half pipe	आधा पाइप बनाता हुआ एक लाल धातु का फ्रेम
shadows of players on court	कोर्ट पर खिलाड़ियों की छाया
a red tennis shoe on players foot	खिलाड़ी के पैर में लाल टेनिस का जूता
clock face on wall date	तारीखी दीवार पर घड़ी का चेहरा
a group of people watching the baseball players	बेसबॉल खिलाड़ियों को देखने वाले लोगों का एक समूह
a woman on the opposite team trying to block the frisbee	विपक्षी टीम की एक महिला फ्रिसबी को रोकने की कोशिश कर रही है
a white stand on road	सड़क पर एक सफेद स्टैंड
Concrete forms in pavement	फुटपाथ में काकंरीट की संरचनाएं
man standing next to fruit stand	फल स्टैंड के बगल में खड़ा आदमी
A bed plastic stamp	एक बिस्तर प्लास्टिक की मोहर
girl showing cow at fair	मेले में गाय दिखाती लड़की
judge on side of court on blue platform	नीले मंच पर अदालत के पक्ष में न्यायाधीश
The top white cross.	शीर्ष पर सफेद क्रॉस।
Dirt on the players pants.	खिलाड़ियों की पैंट पर मिट्टी।
chain-linked fence behind players	खिलाड़ियों के पीछे चेन-लिंक बाड़
White paper on a black stand	काले स्टैंड पर श्वेत पत्र
March 7th is the date on the calendar	कैलेंडर पर 7 मार्च की तारीख है
Tray of white rice and english muffins	सफेद चावल और अंग्रेजी मफिन की ट्रे
a iron stand on back	एक लोहे का स्टैडं पृष्ठ्भुमि पर
red hat on baseball players head	बेसबॉल खिलाड़ी के सिर पर लाल टोपी
black and white tennis court netting	काले और सफेद टेनिस कोर्ट नेटिंग
second set of closed umbrellas	बंद छतरियों का दूसरा सेट
Bright red semi-gloss block wall	चमकदार लाल अर्ध-ग्लोस ब्लॉक दीवार
Three baseball players are in the field.	तीन बेसबॉल खिलाड़ी मैदान में हैं।
A block wall is behind the skate park	स्केट पार्क के पीछे एक ब्लॉक दीवार है
tail fine view of a red plane	एक लाल विमान की पूंछ का दृश्य
a group of ball players practicing	अभ्यास करने वाले गेंद खिलाड़ियों का एक समूह
a fine silver pocket watch	चांदी की उत्तम जेब घड़ी
the date stamp in the corner of the pic	तस्वीर के कोने में तारीख की मोहर
Red circle with white cross under right wing	दक्षिणपंथी के तहत सफेद क्रॉस के साथ लाल सर्कल
a metal stand for the flowers	फूलों के लिए एक धातु स्टैंड
A light reflecting on a tie press.	टाई प्रेस पर से प्रतिबिंबित होने वाला प्रकाश।
loose sediment forms on the rocks	चट्टानों पर ढीला तलछट बना हुआ
the hand is going to press a button	यह हाथ एक बटन दबाने जा रहा है
sign written in english and foreign language	अंग्रेजी और विदेशी भाषा में लिखे गये सन्केत
yellow stamp date near bottom	पीले रंग की तारीख की मोहर तल के पास
Street sign on a pole in english and chinese	अंग्रेजी और चीनी में एक पोल पर मार्ग़ संकेत
an english muffin sandwich	एक अंग्रेजी मफिन सैंडविच
many utility cables cross over the street	कई उपयोगिता केबल सड़क पर से जाते हुए
block sneakers with green laces	ग्रीन लेस के साथ ब्लॉक स्नीकर्स
Brown painted signature and date.	भूरे रन्ग में चित्रित हस्ताक्षर और तारीख
woman is behind the white line of a tennis court	महिला टेनिस कोर्ट की सफेद लाइन के पीछे है
a sign showing cross streets	एक संकेत चौराहा दिखा रहा है
farmer's market stand	किसान के बाज़ार का स्टैडं
banana on the stand	स्टैंड पर केला
logo stamp on the door	दरवाजे पर लोगो की मुहर
english breakfast tea text	अंग्रेजी नाश्ता चाय पाठ
Black bike seat with silver springs.	ब्लैक बाइक सीट सिल्वर स्प्रिंग्स के साथ।
white sign with blue asian characters on it	सफेद चिह्न नीले एशियाई वर्णों के साथ
Big springs on the bottom of train.	ट्रेन के निचले भाग पर बड़े स्प्रिंग्स
Small French coffee press.	छोटा फ्रेंच कॉफी प्रेस।
Landline phone on the night stand	नाइट स्टैंड पर लैंडलाइन फोन
A tin container decorated with Star Wars characters and themes	एक टिन का डब्बा स्टार वार्स पात्रों और विषयों के साथ सजाया हुआ
The players shoes are black.	खिलाड़ियों के जूते काले हैं।
Sis car models on top of each other	एक दूसरे के ऊपर सिस कार की मॉडलें
date of the recording	रिकॉर्डिंग की तारीख
a second pizza in a pan	एक पैन में दूसरा पिज्जा
cross walk lines on street	सड़क पर चलने के रेखाकिंत चिन्ह
two man standing on a tennis court	टेनिस कोर्ट पर खड़े दो शख्स
Cell phone is in stand.	सेल फोन स्टैंड में है।
Blue section of tennis court	टेनिस कोर्ट का नीला अन्श
A white plate with english muffins	अंग्रेजी मफिन के साथ एक सफेद प्लेट
A block in the wall.	दीवार में एक ब्लॉक।
a red sign advertising a fun fair	एक लाल सन्केत एक मजेदार मेले को विज्ञापित करते हुए
a cross on the front of a church	एक चर्च के सामने एक क्रॉस
the fence covered in netting at the end of the court	कोर्ट के अंत में जाल से ढ्का बाड़
Small section of baseline on a tennis court	एक टेनिस कोर्ट पर बेसलाइन का छोटा सा खंड
a platter of fine china	एक बढिया चीनी मिट्टी की थाली
Grey cross on a green dome top.	एक हरे गुंबद के शीर्ष पर ग्रे क्रॉस।
fading on the court	कोर्ट पर मुरझाह्ट
The date 01/03/2008 in yellow.	दिनांक 01/03/2008 पीले रंग में।
information stamp on image	छवि पर जानकारी की मुहर
yellow safety tape at a tennis court	एक टेनिस कोर्ट में पीला सुरक्षा टेप
Balconies on the second story of the buildings	इमारतों के दूसरे स्तर पर बाल्कनियाँ
Shades of the second biker	दूसरे बाइकर का छाया
a small black entertainment stand	एक छोटा काला मनोरंजन स्टैंड
thumb press into a doughnut	डोनट पे दबाव डालते हुए एक अंगूठा
The line on the tennis court is white.	टेनिस कोर्ट पर लाइन सफेद है।
mini hi-fi on small stand	छोटे स्टैंड पर मिनी हाई-फाई
two people stand next to the boat	नाव के पास दो लोग खड़े हैं
an english taxi cab is on the bridge	पुल पर एक अंग्रेजी टैक्सी कैब है
white TV stand on floor	फर्श पर सफेद टीवी स्टैंड
cross that sits atop the column on the left side	क्रॉस जो बाईं ओर के कॉलम के ऊपर है
Two baseball players at the plate	प्लेट में दो बेसबॉल खिलाड़ी
photo date on right	फोटो की तारीख दाहिने ओर
a fine meal on a plate	एक थाली में बढ़िया भोजन
a glass block window	एक ग्लास ब्लॉक की खिड़्की
time and date stamp on the picture	तस्वीर पर समय और तारीख की मुहर
sing is written in chinese and latin characters	गाना चीनी और लैटिन अक्षरों में लिखा गया है
fine, pale sand	महीन, फीका रेत
cone of plane appears dark, shiny and fast	विमान का शंकु गहरे चमकदार और तेज दिखाई देता है
round light gray large cement block	गोल हल्के धूसर रंग का बड़ा सीमेंट ब्लॉक
Large tv on black stand.	काले स्टैंड पर बड़ी टी.वी.
soccer players connect chin and forehead	फुटबॉल खिलाड़ी ठोड़ी और माथा जोड़ते हुए
a round wooden block	एक गोल लकड़ी का ब्लॉक
a juice press	एक जूस प्रेस
Railing on second floor of building	भवन की दूसरी मंजिल पर रेलिंग
white paper with pictures on stand on the table	मेज पर स्टैंड में चित्रों के साथ सफेद कागज
items for sale in stand	स्टैंड में बिक्री के लिए वस्तु
ridged metal pole stand to a large clock	एक बड़ी घड़ी के लिए धातु का बना रिज पोल स्टैडं
Silver metal monitor stand	सिल्वर मेटल मॉनिटर स्टैंड
Landscape shrub models on display	प्रदर्शन पर लैंडस्केप झाड़ी मॉडल
these are baseball players	ये बेसबॉल खिलाड़ी हैं
Cinder block base for fence	बाड़ के लिए सिंडर ब्लॉक बेस
A net in between the players	खिलाड़ियों के बीच एक जाल
the blue 28 on the back of the players shirt	खिलाड़ियों की पीठ पर नीले रंग की 28
the second level of the bus	बस का दूसरा स्तर
characters on the billboard	बिलबोर्ड पर अक्षर
The bolt underneath the springs.	स्प्रिंग्स के नीचे बोल्ट।
The net on a tennis court	एक टेनिस कोर्ट पर नेट
older dude on bicycle in a country where spanish/english are the official languages	वृध व्यक्ति साइकिल पर एक देश में जहां स्पेनिश / अंग्रेजी आधिकारिक भाषाएं हैं
Several models hanging in the air in the exhibit	प्रदर्शनी में हवा में लटके कई मॉडल
black utensils in a wooden block	लकड़ी के ब्लॉक में काले बर्तन
bird second in line	पक्षी दूसरी स्थान में
english flag printed umbrella	अंग्रेजी ध्वज मुद्रित छत्र
stamp on boy's left hand	लड़के के बाएं हाथ पर मोहर
person holding a block of ice	बर्फ का एक खंड पकड़े हुए व्यक्ति
large green and purple tennis court	बड़े हरे और बैंगनी टेनिस कोर्ट
A man taking a picture of the players.	खिलाड़ियों की तस्वीर ले रहा एक आदमी।
Yellow time and date stamp	पिली समय और तारीख मोहर
a fair weather cloud	एक उचित मौसम बादल
orange date print	नारंगी दिनांक प्रिंट
tennis players shaking hands	टेनिस खिलाड़ी हाथ मिलाते हुए
the block of hay	घास का ब्लॉक
there is a building behind the court	कोर्ट अदालत के पीछे एक इमारत है
proprietor of the mobile lemonade stand	मोबाइल नींबू पानी स्टैंड के मालिक
pole behind second baseman	दूसरे बेसमैन के पीछे पोल
Net separating a tennis	एक टेनिस कोर्ट को अलग करते हुए नेट
A table full of fine china.	बढिया चीनी बर्तन से भरी एक मेज।
The items on the top shelf have painted characters on them	शीर्ष शेल्फ पर वस्तुओं पे वर्ण चित्रित हैं
date palms on the grassy field	घास के मैदान में खजूर के पेड़
ground where bike stand	जमीन जहां बाइक खड़े होते हैं
the players are wearing cleats on their shoes	खिलाड़ी अपने जूतों में क्लीट्स पहने हुए हैं
green shrubbery that forms a circle around the pedestal	हरी झाड़ जो पेडस्टल के चारों ओर एक चक्र बनाती है
crosswalk for pedestrians to cross	पदयात्रियों के लिए क्रॉसवॉक
one side is in english	एक तरफ अंग्रेजी में है
The water bottle on the stand	स्टैंड पर पानी की बोतल
pair of hands typing fast on keyboard	कीबोर्ड पर तेजी से टाइप करते हुए हाथों की जोड़ी
second level of building	भवन का दूसरा स्तर
second man looking over first's shoulder	दूसरा आदमी पहले आद्मी के कंधे पर से देख रहा है
The birds are flying fast	पक्षी तेजी से उड़ रहे हैं
time stamp in corner of image	छवि के कोने में समय की मोहर
light stand beside bed	बिस्तर के पास लाइट स्टैंड
date 01/05/2011	दिनांक 01/05/2011
this court is green	यह कोर्ट हरी है
a table filled with assorted models and tools	मिश्रित मॉडलों और उपकरणों से भरी एक मेज़
The cave the wave forms.	गुफा रूपी तरंग ।
baseball players helmet	बेसबॉल खिलाड़ी का हेलमेट
Large cross outside of a church.	चर्च के बाहर एक बड़ा क्रॉस
fence on a baseball court	एक बेसबॉल कोर्ट पर बाड़
large green bench press on the table	मेज़ पर बड़ी हरी बेंच प्रेस
second car attached to train engine	ट्रेन इंजन से जुड़ी दूसरी कार
a white line cross walk.	एक सफेद लाइन क्रॉस वॉक।
expiration date in black ink	काली स्याही में समाप्ति की तारीख
box springs under a bed	एक बिस्तर के नीचे बॉक्स स्प्रिंग्स
white graffiti on a stand	एक स्टैंड पर सफेद भित्तिचित्र
block behind the woman	महिला के पीछे ब्लॉक
Glass safety rail on second floor.	दूसरी मंजिल पर ग्लास सेफ्टी रेल।
White marking on the court	कोर्ट पर सफेद निशान
bolt on cross walk sign	क्रॉस वॉक साइन पर बोल्ट
a white line a cross the field	एक सफेद लाइन मैदान को पार करते हुए
players wearing knee-high socks	खिलाड़ी घुटनों तक उच्च मोजे पहने हुए
second man skiing in snow	बर्फ में दूसरा आदमी स्कीइंग करता हुआ
a few people about to cross the road	सड़क पार करने जा रहे कुछ लोग
stop sign in english and farsi	अंग्रेजी और फारसी में रुकने का सन्केत
a rounded edged wood block	एक गोल बढ़त वाला लकड़ी का ब्लॉक
Television set on wooden stand	लकड़ी के स्टैंड पर टेलीविजन सेट
Four players standing on a tennis court	टेनिस कोर्ट पर खड़े चार खिलाड़ी
the tv stand is blacjk incolor	टीवी स्टैंड काले रन्ग का है
a team of good soccor players.	अच्छे सॉकर खिलाड़ियों की एक टीम।
the angel is holding a cross shield	परी एक क्रॉस शील्ड पकड़े हुए है
a cross on the top of the building	इमारत के शीर्ष पर एक क्रॉस
players watch from the dugout	खिलाड़ी डगआउट से देखते हुए
stand full of baseball fans	स्टैड्ं बेसबॉल प्रशंसकों से भरा हुआ स्टैड्ं
The cat is looking at the second cat.	एक बिल्ली दूसरी बिल्ली को देख रही है।
People with umbrellas waiting to cross the street.	छतरियों वाले लोग सड़क पार करने की प्रतीक्षा कर रहे हैं।
red ground of a tennis court	एक टेनिस कोर्ट का लाल मैदान
the second hand on the clock	घड़ी पर सैकडं का कांटा
the small cross on top of the headstone	हेडस्टोन के ऊपर छोटा सा क्रॉस
White cross walk in road	सड़क में व्हाइट क्रॉस वॉक
rusty springs beneath 'schwinn'	'श्विन' के नीचे जंग लगे स्प्रिंग्स
truck has two white Chinese characters	ट्रक में दो सफेद चीनी अक्षर हैं
a bunch of baseball players waiting for their turn	अपनी बारी की प्रतीक्षा कर रहा एक बेसबॉल खिलाड़ियों का झुंड
The sign is in arabic and english	संकेत अरबी और अंग्रेजी में है
a copy of vanity fair is displayed	वैनिटी फेयर की एक प्रति प्रदर्शित की गई है
the fine is 350 usd	शूल्क 350 ड़ॉलर है
a black second hand	एक काला सैकंड का कांटा
A postage stamp.	एक डाक टिकट।
advertisement on tennis court	टेनिस कोर्ट पर विज्ञापन
A fruit stand on the sidewalk	फुटपाथ पर एक फल स्टैंड
fair large legion of anti-climate change, 350.org, kites with tails in the overcast sky	जलवायु परिवर्तन के उचित बड़े विरासत 350.org, आसमान में पतंगों के साथ पतंग
the banana hanging from the stand	स्टैंड से लटका हुआ केला
a church tower with a cross on the roof	छत पर एक क्रॉस के साथ एक चर्च टॉवर
Lid of glass cake stand	ग्लास केक स्टैंड की ढक्कन
member of opposing team trying to block the shooter's shot	निशानेबाज का शॉट ब्लॉक करने की कोशिश कर रहा विरोधी टीम का सदस्य
the stand is stable	स्टैंड स्थिर है
batter being poured into a waffle press	बैटर को वफ़ल प्रेस में डाला जा रहा है
black metal fence behind a tennis court	एक टेनिस कोर्ट के पीछे काले धातु की बाड़
cross on the church roof	चर्च की छत पर क्रॉस
block on the pole	ध्रुव पर रोक
the second young lady is wearing capri-style jeans	दूसरी युवा महिला ने कैपरी स्टाइल की जींस पहनी हुई है
The blue tennis court	नीला टेनिस कोर्ट
Angels overlooking the cross	क्रॉस को ऊपर से देखते हुए स्वर्गदूत
black Samsung tv on the tv stand	टीवी स्टैंड पर काली सैमसंग की टीवी
Neon green time and date stamp	नियॉन ग्रीन में समय और तारीख की मोहर
the blue handle of a french press	एक फ्रेंच प्रेस के नीले हैंडल
an alarm clock on the night stand	नाईटस्टैंड पर एक अलार्म घड़ी
Dark colored stand a tv is on.	गहरे रंग का स्टैंड एक जिसपर एक टीवी है।
second traffic light on pole	पोल पर दूसरी ट्रैफिक लाइट
Old english writing on board	बोर्ड पर पुरानी अंग्रेजी का लेखन
this is a coffee press	यह एक कॉफी प्रेस है
Green grass forms the ground.	हरी घास ज़मीन पर।
sign laying on the second set of red apples	लाल सेब के दूसरे सेट पर सन्केत रखा हुआ है
A sign in not english	सन्केत अंग्रेजी में नहीं है
black remote on the tv stand	टीवी स्टैंड पर काला रिमोट
Windows logo stamp on laptop.	लैपटॉप पर विंडोज की मोहर।
french press coffee maker on the table	टेबल पर फ्रेंच प्रेस कॉफी मेकर
Black stand with microphone	माइक्रोफोन के साथ काली ब्लैक स्टैंड
little white english car with vertical oblong taillights	लम्बाकार टेललाइट्स के साथ छोटी सफेद अंग्रेजी गाड़ी
aqua press wall with white advertising signs	सफेद विज्ञापन संकेतों के साथ एक्वा प्रेस की दीवार
Soccer players on field.	मैदान पर फुटबॉल खिलाड़ी।
Top of net on tennis court	टेनिस कोर्ट पर नेट का उपरी हिस्सा
Coming fast around the bend	मोड़ के पास तेजी से आते हुए
Blue border around tennis court	टेनिस कोर्ट के चारों ओर ब्लू बॉर्डर
ink stamp print	स्याही मोहर प्रिंट
yellow sticker with asian characters	एशियाई अक्षरों के साथ पी्ली स्टीकर
second seat on motorcycle	मोटरसाइकिल पर दूसरी सीट
four female soccer players on a grassy field	एक घास के मैदान पर चार महिला फुटबॉल खिलाड़ी
date 2008 printed on the label	दिनांक 2008 लेबल पर मुद्रित किया गया है
grass tennis court	घास का टेनिस कोर्ट
colored springs on truck	ट्रक पर रंगीन स्प्रिंग्स
white cement block wall	सफेद सीमेंट ब्लॉक की दीवार
a cats closed eye forms a slit	एक बिल्ली की बंद आंख सँकरी दरार बनाती हुई
the judge's chair by the court	कोर्ट के बगल में न्यायाधीश की कुर्सी
a white surfboard stand next to yellow one	एक सफेद सर्फ़बोर्ड स्टैडं के बगल में पीले सर्फ़बोर्ड
a layer of fine sweet chocolate	महीन मीठी चॉकलेट की एक परत
the watermark is a block font	वॉटरमार्क एक ब्लॉक फ़ॉन्ट है
red second hand on top of other hands	लाल सैकडं कांटा दूसरे कांटो पर
long fine hairs on chin	ठोड़ी पर लंबे महीन बाल
Single white line drawn on tennis court	टेनिस कोर्ट पर खींची गई एक सफेद लकीर
a red cross decal	एक लाल क्रॉस डीकल
Blue garbage can on second floor.	दूसरी मंजिल पर नीला कचरे का डिब्बा।
front of military plane is pointed and fast	सैन्य विमान की नोख तीक्ष्ण और तेज़ है
signature of artist and date	कलाकार के हस्ताक्षर और तारीख
book of forms on desk	डेस्क पर प्रपत्रों की पुस्तक
Silver french press coffee maker	रजत फ्रेंच प्रेस कॉफी मेकर
orange date stamp on photo	तस्वीर पर नारंगी तारीख की मुहर
woman in back of a court	एक कोर्ट के पीछे महिला
the date of the picture	तस्वीर की तारीख
gray color on court	कोर्ट पर ग्रे रंग
small models boats on TV	टीवी पर छोटी मॉडल नावें
glass block privacy wall	ग्लास ब्लॉक गोपनीयता दीवार
red painted lines on wooden court floor	लकड़ी के फर्श पर लाल चित्रित रेखाएँ
red cross with a white background	सफेद पृष्ठभूमि के साथ लाल क्रॉस
soccer players in a light blue uniforms	हल्के नीले रंग की वर्दी में फुटबॉल खिलाड़ी
car moving incredibly fast	तेजी से बढ़ रही कार
a small dark brown night stand	एक छोटे से गहरे भूरे रंग के नाइट स्टैंड
a sign in a language that isn't English	एक संकेत जो अंग्रेजी में नहीं है
silver and black French press coffee pot	चांदी और का्ले रन्ग का फ्रेंच प्रेस कॉफी पॉट
green bench on court	कोर्ट में हरी बेंच
pendent on a fine chain	लटकन एक बढिया चैन पर
Paper forms on the table.	मेज पर कागज।
A ball girl at the back of a tennis court	एक टेनिस कोर्ट के पीछे एक बॉल गर्ल
Thick white wooden cross.	मोटी सफेद लकड़ी का क्रॉस।
the second cushioned seat	दूसरी गद्दी वाली सीट
A black barrier stand.	एक काला अवरोधक स्टैडं।
green surface surrounding tennis court	टेनिस कोर्ट के आसपास की हरी सतह
Silhouette of tennis player on court.	कोर्ट पर टेनिस खिलाड़ी की पर्छाई।
black electric clock on night stand	नाइट स्टैंड पर काली बिजली की घड़ी
a skate boarder going fast	तेजी से जा रहा एक स्केट बोर्डर
5 cars of varying models parked on the street	सड़क पर खड़ी पांच विभिन्न मॉडलों की कारें
Signs on signpost naming streets and block numbers	साइनपोस्ट पर सड़कों के नाम और ब्लॉक नंबर
big hairy fair laps	बड़े बालों वाले गोरे गोद
white edge of white tennis court	सफेद टेनिस कोर्ट का सफेद किनारा
name and date in the corner	नाम और तारीख कोने में
yellowish green grass over fine tan sand	बारीक ताम्र रेत पर पीली हरी घास
small child cross country skiing	क्रॉस कंट्री स्कीइंग करता हुआ छोटा बच्चा
a net divides the court	कोर्ट को विभाजित करता हुआ एक जाल
walking so fast person is captured as a blur	बहुत तेजी से चल रहा ईन्सान एक धुंधले रूप में व्य्क्त हुआ है
the knife block is filled	एक चाकू का ब्लॉक भरा हुआ है
Long forks and springs	लंबे कांटे और स्प्रिंग्स
baseball players dressed in red and gray	बेसबॉल खिलाड़ी लाल और धूसर रंग के कपड़ों में
second paper notice in a row	एक पंक्ति में दूसरा पेपर नोटिस
second story seating area	दूसरी मन्ज़ील पर बैठने की जगह
a cross country skier bending low	नीचे झुकता हुआ एक क्रॉस कंट्री स्कीयर
Shadow running across a tennis court	एक टेनिस कोर्ट के पार जाती हुई परछाई
Coolers in front of the players.	खिलाड़ियों के सामने कूलरें।
Cartoon characters on top of the building.	इमारत के शीर्ष पर कार्टून पात्र।
black lamp with floor stand	स्टैंड के साथ काला दीपक
Security officer making sure everyone is safe at the fair	सुरक्षा अधिकारी सुनिश्चित करते हुए कि सभी लोग मेले में सुरक्षित हैं
the springs are silver	स्प्रिंग्स चांदी के रंग के हैं
sticker is blue+white and i think written in English+kanji	स्टिकर नीला + सफेद है और मुझे लगता है कि अंग्रेजी+कन्जि में लिखा गया है
a white sign not in English	एक सफेद चिह्न अंग्रेजी में नहीं
man working at stand	स्टैंड पर काम कर रहा आदमी
man standing in a tennis court	एक टेनिस कोर्ट में खड़ा आदमी
black band on players wrist	खिलाड़ी की कलाई पर काली पट्टी
Name and date on the bottom right corner.	नीचे दाएं कोने पर नाम और दिनांक।
red second hand	लाल सैक्डं कांटा
orange line on court	कोर्ट पर नारंगी लकीर
date on the screen	स्क्रीन पर तारीख
Baseball cap to block sun	सूरज को ब्लॉक करने के लिए बेसबॉल टोपी
a missing cider block opening to the outside	बाहर की ओर खुलता हुआ एक लापता साइडर ब्लॉक
a cross on the top of the church	चर्च के शीर्ष पर एक क्रॉस
green grass by tennis court	टेनिस कोर्ट के पास हरी घास
Some traffic is moving very fast	कुछ वाहन बहुत तेजी से आगे बढ़ रहे हैं
Large blue flag above the entire fair	पूरे मेले के ऊपर बड़ा नीला झंडा
A crack on the court	कोर्ट में दरार
The tennis players arm extended.	टेनिस खिलाड़ी का हाथ बढ़ा हुआ।
concrete block near street.	सड़क के पास कंक्रीट ब्लॉक।
Number of court on the wall.	दीवार पर कोर्ट की संख्या।
wooden sign with white letters on second bus	दूसरी बस में सफेद अक्षरों के साथ लकड़ी का चिन्ह
exte stamp on yellow metal	पीली धातु पर exte स्टैम्प
tree root jutting out in jagged forms	दांतेदार रूपों में उभ्रे हुए पेड़ की जड़
microphones are lined up on stand	माइक्रोफोन स्टैंड पर पंक्तिबद्ध हैं
the white cross on the flag	ध्वज पर सफेद क्रॉस
the yellow block in the parking stall	पार्किंग स्टाल में पीला ब्लॉक
a sign that forms an X	एक चिन्ह जो X बनाता है
Land forms in the distance	दूरी में भूभाग
playing on green and blue court	हरे और नीले कोर्ट पर खेल
the sport is cross country	यह खेल क्रॉस कंट्री है
this wall forms a stall	यह दीवार एक स्टाल बनाती है
A metal and stone column holding a bell and cross.	एक धातु और पत्थर के स्तंभ एक घंटी और क्रॉस के आधार बनें हुए।
a tea set on a wooden stand	एक लकड़ी के स्टैंड पर एक चाय का सेट
this is a press conference	यह एक प्रेस कॉन्फ्रेंस है
second airplane leaves smoke trail	दूसरा हवाई जहाज धुआँ छोड़ता हुआ
white characters on the street	सड़क पर सफेद अक्षर
people eating fast food	फास्ट फूड खाते हुए लोग
date in the corner	कोने में तारीख
Silver cross necklace	चाँदी का क्रॉस हार
block of snow on a hill	एक पहाड़ पर बर्फ का ब्लॉक
a red and white county fair tent	एक लाल और सफेद काउंटी मेले का तम्बू
long fine whiskers on a cat	एक बिल्ली पर लंबे सुक्ष्म मूंछ
man in a white hat on the tennis court	टेनिस कोर्ट पर एक सफेद टोपी पहने आदमी
a man in a yellow t-shirt sitting cross-legged	पीले टी-शर्ट में एक आदमी पैर मोड़्कर बैठा है
long single block in row	पंक्ति में एक लंबा खंड
Two fine drinking glasses	दो बढिया ठीक पीने के गिलास
green baseball field with players on it	हरी बेसबॉल की मैदान खिलाड़ियों के साथ
Man stand in crane	आदमी क्रेन में खड़ा है
The characters 9F on the side of a plane	एक विमान के किनारे पर अक्षर 9F
English city bus on the road	सड़क पर अंग्रेजी सिटी बस
the date is probably somehow, somewhat primitively digitally conveyed	तारीख शायद किसी तरह कुछ हद तक डिजिटल रूप से बताई गई है
blue plastic hot dog stand	नीले प्लास्टिक का हॉट डॉग स्टैंड
A dirty white dish towel with red cross stripes	लाल क्रॉस धारियों के साथ एक गंदा सफेद डिश तौलिया
Two baseball players talking to each other	बेसबॉल के दो खिलाड़ी आपस में बात करते हुए
long net across the court	कोर्ट के आरपार लंबा जाल
a person cross country skiing in the background	पृष्ठभूमि में क्रॉस कटंरी स्कीइंग करता हुआ एक व्यक्ति
baseball players on field	मैदान पर बेसबॉल खिलाड़ी
Yellow and black pole with a yellow cross.	एक पीले क्रॉस के साथ पीले और काले पोल।
A white box with a red cross.	लाल क्रॉस के साथ एक सफेद बॉक्स।
Bread dough cross hatched design	ब्रेड आटा क्रॉस हैच डिज़ाइन
White boundary lines on the tennis court.	टेनिस कोर्ट पर सफेद सीमा रेखाएं।
waves forms behind the boat	नाव के पीछे लहरें
second floor balcony	दूसरी मंजिल की बालकनी
fast food hot dogs and onion rings	फास्ट फूड हॉट डॉग और प्याज के छल्ले
Time date stamp is bottom right	समय की तारीख की मोहर दाहिने नीचे है
12/22/2006 date stamp	12/22/2006 तारीख की मुहर
fine grey gravel under players' legs	खिलाड़ियों के पैरों के नीचे बारीक ग्रे बजरी
lamp stand light	दीपक स्टैडं की रोशनी
a professional tennis court	एक पेशेवर टेनिस कोर्ट
Tall date palm	ऊंचा खजूर
Dresser with dinosaur models on top	शीर्ष पर डायनासोर मॉडल के साथ ड्रेसर
top of tennis court	टेनिस कोर्ट की जाली का ऊपरी हिस्सा
Woman dressed as a maiden at the fair	मेले में युवती की तरह कपड़े पहने महिला
characters apart on stage set	स्टेज सेट पर अलग से पात्र
Chinese characters on the back of the truck	ट्रक के पीछे चीनी अक्षर
fast blue and white train	तेज नीली और सफेद ट्रेन
players name on his shirt	खिलाड़ी के शर्ट पर उसक़ा नाम
College baseball players on the field.	मैदान पर कॉलेज के बेसबॉल खिलाड़ी।
blue court on the ground	जमीन पर नीला कोर्ट
Two toasted English muffins on a plate.	एक प्लेट पर दो अंग्रेजी टोस्ट मफिन।
Bag on the cement block	सीमेंट ब्लॉक पर थैला
flower on ice block	बर्फ के ब्लॉक पर फूल
yellow tennis balls on court	कोर्ट पर पीली टेनिस की गेंद
A person waiting to cross the street	एक व्यक्ति सड़क पार करने की प्रतीक्षा में
tan colored brick block wall	ताम्र रंग की ईंट ब्लॉक दीवार
A dark wooden cross with a small sign attached	एक छोटे संकेत के साथ एक लकड़ी का क्रॉस
A clock with cartoon characters on	कार्टून पात्रों के साथ एक घड़ी
rocky and rectangular block with openings on dirt	चट्टानी और आयताकार छेद वाले ब्लॉक मिट्टी पर
adult on a tennis court	एक टेनिस कोर्ट पर वयस्क
Knives in a wooden block on the countertop.	काउंटरटॉप पर एक लकड़ी के ब्लॉक में चाकू।
leg of the second person	दूसरे व्यक्ति का पैर
awning for food stand	फूड स्टैंड के लिए शामियाना
Knives in a wooden block behind the stove.	चूल्हे के पीछे एक लकड़ी के ब्लॉक में चाकू।
a red newspaper stand	एक लाल अखबार स्टैंड
Brown block and white house with pitched black roof.	ब्राउन ब्लॉक और सफेद घर जिसमें काली छत है।
The train is traveling in fair weather	ट्रेन उचित मौसम में यात्रा कर रही है
fast food on white plate	सफेद प्लेट पर फास्ट फूड
air forces flag	वायु सेना का झंडा
some watery plant forms	कुछ गिले पौधे
curves of forms worn over shoes on snowboard	स्नोबोर्ड पर जूतों के ऊपर पहने जाने वाले रूपों के वक्र
woman sitting on a stone block	पत्थर के ब्लॉक पर बैठी महिला
black lamb second from right	दाईं ओर से दूसरा का्ले भेड़ का बच्चा
blue wall of the court	कोर्ट की नीली दीवार
a wood night stand.	एक लकड़ी की नाईट स्टैंड।
the wall is cement block	दीवार सीमेंट ब्लॉक है
the court is dark blue	कोर्ट गहरा नीला है
The man's black shadow on the court	कोर्ट पर आदमी की काली छाया
Woman standing on tennis court	टेनिस कोर्ट पर खड़ी महिला
a music stand on a curb	एक वक्र पर एक संगीत स्टैंड
a weed growing up from the tennis court	एक खरपतवार टेनिस कोर्ट से ऊग रहा है
The military plane has a cross on the tail.	सैन्य विमान की पूंछ पर एक क्रॉस है।
small food press on stove	स्टोव पर छोटा भोजन प्रेस
two bicyclists waiting to cross intersection	चौराहा पार करने का इंतजार कर रहे दो साइकिल सवार
cross nailed to a wall	कील से ठुकी हुई दीवार पर एक क़्रॉस
Wooden butcher block on kitchen sink.	रसोई के सिंक पर लकड़ी का कसाई ब्लॉक।
three black Japanese characters	तीन काले जापानी वर्ण
microphone on angled stand	एंगल्ड स्टैंड पर माइक्रोफोन
Look of concentration on game players face	खेल खिलाड़ियों के चेहरे पर दिखाई देती हुई एकाग्रता
blue cross on front of car	कार के सामने नीली क्रॉस
the blue painted do not cross line on the train platform	ब्लू पेंट निषिद्ध करने हेतु लकीर ट्रेन प्लेटफॉर्म पर
tennis match in progress on outdoor court	आउटडोर कोर्ट पर टेनिस मैच चल रहा है
Two men on a tennis court playing tennis	टेनिस खेलने वाले टेनिस कोर्ट पर दो आदमी
wood block of knives	चाकू की लकड़ी ब्लॉक
A block of brown stones.	भूरे पत्थरों का एक ब्लॉक।
players' names in black on yellow background	पीले रंग की पृष्ठभूमि पर खिलाड़ियों के नाम
an off white set of box springs	बॉक्स स्प्रिंग्स का एक ऑफ व्हाइट सेट
Blue characters on a white background	एक सफेद पृष्ठभूमि पर नीले वर्ण
TV on the stand.	स्टैंड पर टी.वी.
Yellow ball on the court.	कोर्ट पर पीली गेंद।
Electrical wire stand	बिजली के तारों क स्टैंड
cross made of stone	पत्थर से बना क्रॉस
The traffic light has a red cross.	ट्रैफिक लाइट में लाल क्रॉस है।
ball on a tennis court	एक टेनिस कोर्ट पर गेंद
cross walk area painted on the street	सड़क पर चित्रित क्रॉस वॉक एरिया
Brown stand holding bananas.	केले के साथ ब्राउन स्टैंड।
the line that shows foul or fair	रेखा जो बेईमानी या निष्पक्षता दिखाती है
Knob above knife block	चाकू ब्लॉक के ऊपर घुंडी
A time stamp on a video.	एक वीडियो पर समय की मोहर।
a clock on a glass stand	एक ग्लास स्टैंड पर एक घड़ी
One person on the court	कोर्ट पर एक व्यक्ति
Road block submerged by water	पानी में डूबा रोड ब्लॉक
tennis court floor is blue	टेनिस कोर्ट की सतह नीली है
baseball players signing autographs	हस्ताक्षर करने वाले बेसबॉल खिलाड़ी
fine metal safety netting	बढिया धातु का सुरक्षा जाल
An audience witnessing a press conference	एक प्रेस कॉन्फ्रेंस के साक्षी बने दर्शक
players in team dugout	खिलाड़ी टीम डगआउट में
white frisbee in players hands	खिलाड़ियों के हाथों में सफेद फ्रिसबी
time and date stamp	समय और तारीख की मोहर
A TV stand	एक टीवी स्टैंड
The time stamp display window on the meter on the left.	बाईं ओर मीटर पर टाइम स्टैम्प डिस्प्ले विंडो।
a wooden block of knives	चाकूओं का एक लकड़ी का ब्लॉक
a second story railing	एक दूसरे मन्ज़िल की रेलिंग
This is a picture of Chinese characters	यह चीनी पात्रों की एक तस्वीर है
fast super jet hovers in the sky	आकाश में घूमता हुआ तेज सुपर जेट
the players are moving	खिलाड़ी आगे बढ़ रहे हैं
two guys in the background are observing the movements of the players	पृष्ठ्भूमी के दो लोग खिलाड़ियों की हरकतों को देख रहे हैं
Curled metal legs on a candle stand	कैंडल स्टैंड पर धातु के घुमावदार पैर
two players watching the batter	बैटर को देखते दो खिलाड़ी
fine white spray against nose of craft	विमान की नाक पर सुक्ष्म सफेद स्प्रे
Brown tennis court floor	भुरी टेनिस कोर्ट का फर्श
cross on top of church	चर्च के शीर्ष पर क़्रॉस
copyright and date	कॉपीराइट और दिनांक
A sign for the 550 west block of Bliss Ct.	ब्लिस सीटी के 550 पश्चिम ब्लॉक के लिए एक संकेत।
Opponent Reaching Out to block	विरोधी ब्लॉक करने की कोशिश करते हुए
Laptop on a stand	एक स्टैंड पर लैपटॉप
a wooden block sitting on the table	टेबल पर एक लकड़ी का ब्लॉक
Part of the tennis court is green.	टेनिस कोर्ट का एक हिस्सा हरा है।
two players in orange and white sitting on sidelines	किनारे पर बैठे नारंगी और सफेद में दो खिलाड़ी
date stamp of photo	फोटो की तारीख मोहर
a pole of a lamp stand	एक दीपक स्टैंड की एक पोल
the door of second floor is brown	दूसरी मंजिल का दरवाजा भूरा है
Front wheel on second white truck.	दूसरा सफेद ट्रक पर सामने का पहिया।
the second gold horse	दूसरा सोने का घोड़ा
A small grey block on the median	माध्यिका पर एक छोटा ग्रे ब्लॉक
Woman on a tennis court	टेनिस कोर्ट पर महिला
red characters on top of blue building	नीली इमारत के शीर्ष पर लाल वर्ण
the collar decoration of a fair isle type sweater	एक बढिया आइल प्रकार स्वेटर की कॉलर की सजावट
Woman wearing a cross on her neck	महिला ने गले में क्रॉस पहना हुआ है
a colorful display lighted characters	रोशन पात्रों का एक रंगीन प्रदर्शन
The second train car	दूसरी ट्रेन की गाड़ी
the players arm is ready to throw	खिलाड़ी का हाथ फेंकने के लिए तैयार है
date and time stamp in corner	कोने में तारीख और समय की मोहर
Two characters on the television	टेलीविजन पर दो किरदार
blue net around tennis court	टेनिस कोर्ट के आसपास नीला जाल
a block paved sidewalk	एक ब्लॉक फुटपाथ
a orange bottle in stand	स्टैंड में एक नारंगी बोतल
The items of the second rack	दूसरे रैक के आइटम
tan grey fine sand	ताम्र धूसर महिन रेत
fence in back of the court	अदालत के पीछे बाड़
five glass vases on the stand	स्टैंड पर पांच ग्लास के फूलदान
white Asian language characters painted on middle of street	सड़क के बीच में चित्रित किया गया सफेद एशियाई भाषा के अक्षर
second leaf from left	बाएं से दूसरा पत्ता
white fast logo in corner	कोने में सफेद फास्ट की लोगो
a large concrete block	एक बड़ा कंक्रीट ब्लॉक
a player on second base	दूसरे बेस पर एक खिलाड़ी
fondant characters on cake	केक पर फोन्डेंट से बने पात्र
grey characters on a sign	एक संकेत पर धूसर वर्ण
Red tie with Peanuts characters	मूंगफली के पात्रों के साथ लाल टाई
press here sticker on paw	"पंजा पर ""यहाँ दबाएं"" स्टिकर"
a sign in a zoo, written in catalan - spanish – english	एक चिड़ियाघर में एक संकेत जो साह - स्पेनिश - अंग्रेजी में लिखा गया है
White letters and numbers, indicating date and photographer.	श्वेत पत्र और संख्या जो तिथि और फ़ोटोग्राफ़र को दर्शाते हैं।
window on second level	दूसरे स्तर पर खिड़की
yellow date and time stamp	पीला तारीख और समय टिकट
players playing base ball on field	मैदान पर बेस बॉल खेलने वाले खिलाड़ी
a black fine tooth comb	एक महिन काले दांत कंघी
a second daybed in room	दूसरे दिन कमरे में
lots of kick+grab marks on white wall below blurry words of graffiti [likely not in english]	भित्तिचित्रों के धुंधले शब्दों के नीचे सफेद दीवार पर बहुत सारे किक + हड़पने के निशान [अंग्रेजी में नहीं]
people enjoying themselves at the fair	लोग मेले में आनंद ले रहे हैं
bananas and oranges on fruit stand	फलों के स्टैंड पर केले और संतरे
A small food stand on wheels.	पहियों पर एक छोटा भोजन स्टैंड।
fine china plate with gold rim	सोने रिम के साथ महिन चीन प्लेट
a white alarm clock is on top of the night stand	रात के स्टैंड के ऊपर एक सफेद अलार्म घड़ी है
baseball players sitting in dugout	डगआउट में बैठे बेसबॉल खिलाड़ी
letter on the wood block	लकड़ी के ब्लॉक पर पत्र
Two butcher block knive sets.	दो कसाई ब्लॉक चाकू सेट।
A sideways rendered date stamp	एक बग़ल में तारीख की मुहर लगी
White second story porch	दूसरी सफेद कहानी पोर्च
a door on the side of the court	कोर्ट की तरफ एक दरवाजा
a block defining the space for the bench	खंड के लिए स्थान को परिभाषित करने वाला एक ब्लॉक
block of white text	सफेद पाठ का खंड
a brown cat is stand	एक भूरी बिल्ली खड़ी है
A train is going very fast	एक ट्रेन बहुत तेज चल रही है
Red and white Stop sign with characters in a non-English language	गैर-अंग्रेजी भाषा में वर्णों के साथ लाल और सफेद स्टॉप साइन
the shin guard on the players leg	खिलाड़ियों के पैर में पिंडली की रक्षा
A tennis player standing in the court	कोर्ट में खड़ा एक टेनिस खिलाड़ी
women waiting to cross	पार करने के लिए इंतजार कर रही महिलाओं
blue tennis court with painted white boundary lines	नीले रंग की टेनिस कोर्ट जिसमें सफेद बाउंड्री लाइन है
white asphalt with fine lines	महिन लाइनों के साथ सफेद डामर
date the photo was taken	तारीख फोटो ली गई थी
block of cheese on plate	प्लेट पर पनीर का ब्लॉक
They both are playing on a tennis court.	वे दोनों एक टेनिस कोर्ट पर खेल रहे हैं।
leaves on tennis court	टेनिस कोर्ट पर पत्ते
a cross street sign	एक क्रॉस स्ट्रीट साइन
the net across their court	उनके दरबार में जाल
geyer springs street sign	गीयर स्प्रिंग्स स्ट्रीट साइन
couple guys walking on tennis court	टेनिस कोर्ट पर घूमते युगल
wooden cross hanging on a wall	एक दीवार पर लटका लकड़ी का क्रॉस
cross structures for bridge support	पुल समर्थन के लिए क्रॉस संरचनाओं
boy standing on tennis court	टेनिस कोर्ट पर खड़ा लड़का
Banana shaped yellow banana stand	केले के आकार का पीला केला स्टैंड
A person below the date	तारीख से नीचे का व्यक्ति
green tennis court with white lines	सफेद लाइनों के साथ हरी टेनिस कोर्ट
man stand on skateboard	आदमी स्केटबोर्ड पर खड़ा है
The front wheel of the second bus.	दूसरी बस का आगे का पहिया।
Bizarre sculpture on a coffee stand	एक कॉफी स्टैंड पर विचित्र मूर्तिकला
large cement block	बड़ा सीमेंट ब्लॉक
this stand is yellow in color	यह स्टैंड पीले रंग का है
date stamp of scene	दृश्य का दिनांक टिकट
Propellers too fast to see.	देखने में बहुत तेज प्रोपेलर
a block, yellow, and white baseball uniform	एक ब्लॉक, पीला, और सफेद बेसबॉल वर्दी
players shoes are black, red, and white	खिलाड़ियों के जूते काले, लाल, और सफेद होते हैं
The players are giving a high five	खिलाड़ी उच्च पांच दे रहे हैं
person has a stamp on her hand	व्यक्ति के हाथ में एक मोहर है
Copy right date 2010	सही तिथि 2010 की प्रतिलिपि बनाएँ
low grey wall behind players	खिलाड़ियों के पीछे कम ग्रे दीवार
a green part of a tennis court.	एक टेनिस कोर्ट का एक हरा हिस्सा।
the second street light	दूसरी स्ट्रीट लाइट
Two tennis players standing together	एक साथ खड़े दो टेनिस खिलाड़ी
two tennis players wearing black shorts	काले शॉर्ट्स पहने दो टेनिस खिलाड़ी
the players socks are blue	खिलाड़ियों के नीले मोजे हैं
A red date stamp	एक लाल तारीख की मोहर
Monitor stand below monitor	मॉनीटर स्टैंड के नीचे मॉनीटर
a manual press machine	एक मैनुअल प्रेस मशीन
long black pipe on display stand	प्रदर्शन स्टैंड पर लंबे काले पाइप
male cross country skier	पुरुष क्रॉस कंट्री स्कीयर
models of airplanes on the tables	तालिकाओं पर हवाई जहाज के मॉडल
Man cross country skiing.	मैन क्रॉस कंट्री स्कीइंग।
the sign has white characters	साइन में सफेद अक्षर हैं
red time stamp on the photo	फोटो पर लाल समय की मोहर
little girl standing on a tennis court	टेनिस कोर्ट पर खड़ी एक छोटी लड़की
man cross country skiing during race	दौड़ के दौरान आदमी क्रॉस कंट्री स्कीइंग
Cement forms sticking out of ground.	जमीन से चिपके हुए सीमेंट के रूप।
Sandwich on the second shelf.	दूसरे शेल्फ पर सैंडविच।
the english muffins are toasted	अंग्रेजी मफिन सिका हुआ हैं
yellow front of second train	दूसरी ट्रेन का पीला मोर्चा
models posing on motorcycle	मोटर साइकिल पर प्रस्तुत मॉडल
This open-air stand takes place in Jamaica	यह ओपन-एयर स्टैंड जमैका में होता है
clear stand for controller	नियंत्रक के लिए स्पष्ट स्टैंड
black armed forces name on wing	काले सशस्त्र बलों के नाम विंग पर
second base found directly behind the pitcher	दूसरा आधार सीधे घड़े के पीछे मिला
A cross on a tower.	एक टॉवर पर एक क्रॉस।
picture taken at drive up fast food chain	फास्ट फूड चेन ड्राइव पर लिया गया चित्र
two horses stand on hill	दो घोड़े पहाड़ पर खड़े हैं
cross centered in curved panels	घुमावदार पैनलों में क्रॉस केंद्रित है
white stripes in road is a pedestrian cross walk	सड़क में सफ़ेद धारियाँ एक पैदल यात्री क्रॉस वॉक हैं
Box springs of bed.	बॉक्स बिस्तर के स्प्रिंग्स।
The water bottle on the side of the court.	कोर्ट की तरफ पानी की बोतल।
A small wave forms on the water.	पानी पर एक छोटी लहर बनती है।
a daytime picture of a couple cross country skiing	एक युगल क्रॉस कंट्री स्कीइंग की एक दिन की तस्वीर
Cars moving at a very fast speed	बहुत तेज गति से चलती हुई कारें
a tree on a city block	एक शहर ब्लॉक पर एक पेड़
a cement block wall	एक सीमेंट ब्लॉक दीवार
computer monitor on the stand	स्टैंड पर कंप्यूटर मॉनिटर
snow on the trees at a cross-country ski race	एक क्रॉस-कंट्री स्की रेस में पेड़ों पर बर्फ
the second engine of the train	ट्रेन का दूसरा इंजन
a black music stand	एक काला संगीत स्टैंड
chairs and tables on the side of the court	कोर्ट की तरफ कुर्सियां ​​और टेबल
Baseball travelling fast in the air	हवा में तेजी से यात्रा कर रहा बेसबॉल
fast food soda cups	फास्ट फूड सोडा कप
An old wooden stand shade	एक पुराना लकड़ी का स्टैंड शेड
red on players sleeve	खिलाड़ियों की आस्तीन पर लाल
a stand next to the sink	सिंक के बगल में एक स्टैंड
second hand on clock	घड़ी पर दूसरा हाथ
four men on court	कोर्ट पर चार आदमी
a block wall behind the man	आदमी के पीछे एक ब्लॉक दीवार
cross walk at intersection	चौराहे पर पैदल चलना
large tennis court	बड़े टेनिस कोर्ट
Child sitting cross-legged on the floor	बच्चा फर्श पर क्रॉस-लेग किया हुआ बैठा था
Man standing on a tennis court	एक टेनिस कोर्ट पर खड़ा आदमी
yellow time date stamp	पीले समय की तारीख मोहर
Turnstyle entrance to court	कोर्ट में टर्नस्टाइल प्रवेश
horse running fast with cowboy on the back	पीठ पर चरवाहे के साथ तेजी से दौड़ता हुआ घोड़ा
blue umbrella pole held fast by sand	नीली छतरी वाला खंभा रेत से भरा हुआ
blue wood life guard stand	नीली लकड़ी जीवन रक्षक स्टैंड
gloves are in the players back pocket	दस्ताने खिलाड़ियों की जेब में हैं
seats in the stand	स्टैंड में सीटें
the players glove is black	खिलाड़ियों का दस्ताना काला है
a brown horse with an english saddle	एक अंग्रेजी काठी के साथ एक भूरे रंग का घोड़ा
The canvas sits on the stand	कैनवास स्टैंड पर है
a camera on a stand	एक स्टैंड पर एक कैमरा
net of the tennis court	टेनिस कोर्ट का जाल
man sitting in fruit stand	फल स्टैंड में बैठा आदमी
grill press	ग्रिल प्रेस
cross on tower steeple	टॉवर स्टीपल पर क्रॉस
ink stamp in the pencil box	पेंसिल बॉक्स में स्याही मोहर
small table lamp on the night stand	नाइट स्टैंड पर छोटा टेबल लैंप
series of curved forms around body	शरीर के चारों ओर घुमावदार रूपों की श्रृंखला
a clock on a wooden block	लकड़ी के ब्लॉक पर एक घड़ी
edge of a stamp	मोहर की किनारों
a man sitting cross legged in the grass	पार बैठे एक आदमी ने घास में पैर रखा
Right ear of the second cat	दूसरी बिल्ली का दाहिना कान
a fine bristled retractable brush	एक अच्छा ब्रिस्टल वापस लेने योग्य ब्रश
A motorcyclist driving very fast	एक मोटर साइकिल चालक बहुत तेजी से गाड़ी चला रहा है
a baseball players bat	एक बेसबॉल खिलाड़ी बल्लेबाजी करते हैं
A second sandwich on a wrapper.	एक रैपर पर दूसरा सैंडविच।
case with cross on it also has red trim	इस पर क्रॉस के साथ लाल ट्रिम भी है
a railing on a second story balcony	एक दूसरी बालकनी पर एक रेलिंग
Two soccer players	दो फुटबॉल खिलाड़ी
the cross on the top of the building structure	भवन संरचना के शीर्ष पर क्रॉस
People waiting to cross street	सड़क पार करने का इंतजार करते लोग
characters on the sign	संकेत पर अक्षर
A skateboard with asian characters painted on the underside	एशियाई पात्रों के साथ एक स्केटबोर्ड अंडरस्लाइड पर चित्रित
fine inscriptions on item	मद पर ठीक शिलालेख
characters are posted in Chinese	पात्रों को चीनी में पोस्ट किया जाता है
Man getting ready for a penalty kick	मैन पेनल्टी किक के लिए तैयार हो रहा है
A red cross forms on the floor.	फर्श पर एक लाल क्रॉस रूपों।
many wires criss-cross overhead	कई तारों को क्रॉस-ओवरहेड किया जाता है
This could be at a science fair.	यह एक विज्ञान मेले में हो सकता है।
man using a hand press to make juice	जूस बनाने के लिए हैंड प्रेस का उपयोग करने वाला व्यक्ति
The picture has a date stamp	तस्वीर पर तारीख की मोहर है
A date underneath a clock face	एक घड़ी के चेहरे के नीचे एक तारीख
unfinished wood block under freezer	फ्रीजर के तहत अधूरा लकड़ी का ब्लॉक
fast train moving along track	ट्रैक के साथ चलती तेज ट्रेन
Three baseball players wearing white uniforms are in the background.	सफेद वर्दी पहने तीन बेसबॉल खिलाड़ी पृष्ठभूमि में हैं।
tennis player on the green colored section of a court	एक कोर्ट के हरे रंग के खंड पर टेनिस खिलाड़ी
making a very fast turn	बहुत तेज़ मोड़ देना
the tennis court net divides the court in the middle	टेनिस कोर्ट का जाल कोर्ट को बीच में बांटता है
4 players on the court	4 खिलाड़ी कोर्ट पर
the chinese characters on the vase	फूलदान पर चीनी अक्षर
crumbly english muffin bread	crumbly english मफिन ब्रेड
a stand with information	जानकारी के साथ एक स्टैंड
ad on the wall of the court	अदालत की दीवार पर विज्ञापन
The right front window on the second level of the bus.	बस के दूसरे स्तर पर दाईं ओर की खिड़की।
the Asian characters are red	एशियाई पात्र लाल हैं
block tower on top of hill	पहाड़ी की चोटी पर ब्लॉक टॉवर
The black baseball mit on the players hand	खिलाड़ियों के हाथ पर काली बेसबॉल माइट
yellow cross on a tie	एक टाई पर पीला क्रॉस
five baseball players	पांच बेसबॉल खिलाड़ी
large date palm in the distance	दूरी में बड़ी खजूर
Cows laying down in the hay at a county fair	काउंटी के एक मेले में गायों को लेटाया गया
armed forces identifying patch for US Army	अमेरिकी सेना के लिए पैच की पहचान करने वाले सशस्त्र बल
The tennis court is two different colors.	टेनिस कोर्ट दो अलग-अलग रंग हैं।
A indoor tennis court.	एक इनडोर टेनिस कोर्ट।
characters on the edge of the plate	प्लेट के किनारे पर अक्षर
a fruit stand with lots of fruits and vegetables	बहुत सारे फल और सब्जियों के साथ एक फल स्टैंड
red white and blue truck is at the fair	लाल, सफेद और नीला ट्रक मेले में है
yellow date taken stamp	पीली तारीख की मोहर
Tarp on the side of the court	कोर्ट की तरफ से तारप
Tall lights at the court	कोर्ट में लगी लाइटें
players standing behind chain link fence	चेन लिंक बाड़ के पीछे खड़े खिलाड़ी
date stamp in the corner	कोने में तारीख मोहर
a cross in a church	एक चर्च में एक क्रॉस
easel stand for painting	चित्र के लिए चित्रफलक स्टैंड
owners manual for a panini press	मालिकों के लिए एक पैनी प्रेस है
dog forms splashes in the water	कुत्ते ने पानी में छींटे मारे
two long and narrow panes below cross bar	क्रॉस बार के नीचे दो लंबे और संकीर्ण पैन
Double red doors on second floor	दूसरी मंजिल पर डबल लाल दरवाजे
Partial view of second bus	दूसरी बस का आंशिक दृश्य
White door on second floor	दूसरी मंजिल पर सफेद दरवाजा
a romantic date night	एक रोमांटिक मुलाक़ात की रात
knife block sitting on counter with knives in it	चाकू के साथ काउंटर पर बैठे चाकू ब्लॉक
a block of buildings	इमारतों का एक ब्लॉक
Curved stairs on the approach to the court yard	कोर्ट यार्ड की ओर जाने वाली घुमावदार सीढ़ियां
chinese characters on the side of a bus	एक बस के किनारे चीनी अक्षर
blue tennis court	नीला टेनिस कोर्ट
This person is waiting to cross the street	यह व्यक्ति सड़क पार करने की प्रतीक्षा कर रहा है
The block for the post	पद के लिए ब्लॉक
tan letters on the tennis court	टेनिस कोर्ट पर टैन पत्र
this license plate has non-english characters	इस लाइसेंस प्लेट में गैर-अंग्रेजी अक्षर हैं
players uniform is black and gold	खिलाड़ियों की वर्दी काले और सोने रंग की है
Watermark, showing copyright date.	वॉटरमार्क, कॉपीराइट दिनांक दिखा रहा है।
name and website of photographer and Chinese characters	फोटोग्राफर और चीनी पात्रों का नाम और वेबसाइट
tv on a stand	एक स्टैंड पर टी.वी.
grass grows next to the block	ब्लॉक के बगल में घास उगती है
A paper towel roll on a stand	एक स्टैंड पर एक पेपर टॉवल रोल
white springs under mattress	गद्दे के नीचे सफेद स्प्रिंग्स
The brick wall behind the court	कोर्ट के पीछे ईंट की दीवार
egg shaped object on a stand	एक स्टैंड पर अंडे के आकार की वस्तु
tennis ball shadow on the court	कोर्ट पर टेनिस बॉल की छाया
littleyiye photographers stamp	लिटिलिआ फोटोग्राफरों का टिकट
Picture stamped date 8/10/2013.	चित्र मुद्रांकित दिनांक 8/10/2013।
2010 date in black	काले रंग में 2010 की तारीख
sign above the people at the fair	मेले में लोगों के ऊपर दिखने वाला साइन
Straight fine black hair	सीधे उत्कृष्ट काले बाल
a horse with an english saddle	एक अंग्रेजी सैडल के साथ एक घोड़ा
the baby has very fine hair	बच्चे के बाल बहुत अच्छे हैं
pelican forms ripples with legs	श्रोणि पैरों के साथ तरंग बनाता है
A window on a second story shop.	एक दूसरी कहानी की दुकान पर एक खिड़की।
Green stand in the snow.	बर्फ में हरा स्टैंड।
display models of cell phones	सेल फोन के प्रदर्शन मॉडल
black chinese characters n white sign	काले चीनी अक्षर और सफेद संकेत
Shadow of the man on the tennis court	टेनिस कोर्ट पर आदमी की छाया
white marking on tennis court	टेनिस कोर्ट पर सफेद निशान
Baby fine light brown hair.	बच्चे की ठीक हल्के भूरे बाल।
the players lean on the fence	खिलाड़ी बाड़ पर झुक जाते हैं
second suitcase on bottom is orange	नीचे दूसरा सूटकेस नारंगी है
Man helping child stand on snowboard	स्नोबोर्ड पर खड़े होने में बच्चे की मदद कर कर रहा आदमी
extremely fast bullet train	बेहद तेज जाता बुलेट ट्रेन
Oriole on front of players hat	खिलाड़ियों की टोपी पर ओरिओल
Net across the tennis court	टेनिस कोर्ट में नेट
second car parked on the street	दूसरी कार सड़क पर खड़ी थी
Cather's mit for hand protection against fast pitches.	तेजी से पिचों के खिलाफ हाथ की सुरक्षा के लिए कैथरीन की माइट।
fast food chicken patty	फास्ट फूड चिकन पैटी
sunglasses of second rider	दूसरे सवार का धूप का चश्मा
People buying food on fast food store	फास्ट फूड स्टोर पर खाना खरीदते लोग
second animal in the back	पीठ में दूसरा जानवर
the stand under the tv	टीवी के नीचे खड़े हो जाओ
tennis court with white stripes	सफेद धारियों वाला टेनिस कोर्ट
kick stand on motorcycle	मोटरसाइकिल पर किक स्टैंड
chainlink fencing forms a field exit	चेनलिंक बाड़ लगाना एक क्षेत्र से बाहर निकलता है
Wall design of people characters.	लोगों के पात्रों की दीवार डिजाइन।
the sidewalk in front of the produce stand	उपज स्टैंड के सामने फुटपाथ
concrete or cinder block walls	कंक्रीट या सिंडर ब्लॉक दीवारें
The tv stand is made of wood	टीवी स्टैंड लकड़ी से बना है
the models perky lips	मॉडल दिलेर होंठ
Three baseball players at first base	पहले बेस पर तीन बेसबॉल खिलाड़ी
block of black butcher knives	काले कसाई चाकू के ब्लॉक
pointing sign in english and chinese	अंग्रेजी और चीनी में सांकेतिक संकेत
Lamp on the night stand to the left of the bed	बिस्तर के बाईं ओर नाइट स्टैंड पर दीपक
Date stamp of March 16th, 2008	16 मार्च 2008 की तारीख मोहर
coca cola international logo, written in english, probably repeated below	कोका कोला अंतरराष्ट्रीय लोगो, अंग्रेजी में लिखा है, शायद नीचे दोहराया
a white sign with black Asian characters going vertically	काले एशियाई पात्रों के साथ एक सफेद लंबवत रूप संकेत
bicycle stamp on road	सड़क पर साइकिल की मुहर
neon sign in a second floor window	दूसरी मंजिल की खिड़की में नीयन साइन
this couple is on a date	यह जोड़ी डेट पर है
Mcdonald's advertisement in a language other than english	अंग्रेजी के अलावा अन्य भाषा में मैकडॉनल्ड्स का विज्ञापन
rolls of towels on stand	स्टैंड पर तौलिए के रोल
many glorious forms of opportunistic weeds	अवसरवादी मातम के कई शानदार रूप
kids at a fair eating	बच्चे मेले में खा रहे हैं
a block lower half of a wall	एक दीवार के निचले आधे हिस्से को ब्लॉक करें
jelly jar on top of a chopping block	एक काट ब्लॉक के शीर्ष पर जेली जार
yellow poles by the cross sign	क्रॉस साइन द्वारा पीले डंडे
orange time and date stamp	नारंगी समय और तारीख मोहर
Two female tennis players shaking hands	दो महिला टेनिस खिलाड़ी हाथ मिलाते हुए
A wooden stand	एक लकड़ी का स्टैंड
Four baseball players on field.	मैदान पर चार बेसबॉल खिलाड़ी।
an American flag in the background of a press conference	एक प्रेस कॉन्फ्रेंस की पृष्ठभूमि में एक अमेरिकी झंडा
two english spaniels standing near a person	एक व्यक्ति के पास खड़े दो अंग्रेजी स्पैनियल्स
There is a book stand that is filled with books.	पुस्तकों से भरा एक पुस्तक स्टैंड है।
man taking pictures of players	खिलाड़ियों की तस्वीरें ले रहा आदमी
Black hat with a red cross	काली टोपी के साथ एक लाल क्रॉस
three baseball players standing in a row	तीन बेसबॉल खिलाड़ी एक पंक्ति में खड़े हैं
A black and brown dog fast asleep on the couch.	एक काला और भूरा कुत्ता सोफे पर गहरी नींद में सो गया।
the time stamp sitting in the corner	कोने में बैठे समय की मोहर
yellow plane with characters	पात्रों के साथ पीला विमान
Buttons for pedestrians to cross the street	सड़क पार करने के लिए पैदल यात्रियों के लिए बटन
A stand mixer	एक स्टैंड मिक्सर
this players is shirtless	यह खिलाड़ी शर्टलेस है
pattern on side of second giraffe	दूसरी जिराफ की तरफ पैटर्न
a block on the ground	जमीन पर एक ब्लॉक
bicycles in stand	स्टैंड में साइकिल
a man photographs two baseball players	दो बेसबॉल खिलाड़ियों की तस्वीरें खींचता एक आदमी
a red don't cross signal.	पार मत करो का एक लाल सिग्नल
French coffee press	फ्रेंच कॉफी प्रेस
black bicycle seat with supporting springs	समर्थन स्प्रिंग्स के साथ काली साइकिल सीट
propeller is moving fast	प्रोपेलर तेजी से आगे बढ़ रहा है
toy models of buses	बसों के खिलौना मॉडल
a motorcycle going fast	एक तेजी से जा रही मोटरसाइकिल
Shadow on the court	कोर्ट पर छाया
A brick wall separating players and spectators.	खिलाड़ियों और दर्शकों को अलग करने वाली एक ईंट की दीवार।
a fast moving hand	तेजी से बढ़ रहा हाथ
The night stand is wooden.	नाइट स्टैंड लकड़ी का है।
baseball players posing together in an old photograph	बेसबॉल खिलाड़ी एक पुरानी तस्वीर में एक साथ पोज़ देते हुए
Net across tennis court	टेनिस कोर्ट के आर-पार नेट
glass top on night stand	नाइट स्टैंड पर ग्लास टॉप
raised cross on top of remote control	रिमोट कंट्रोल के शीर्ष पर उच्चा क्रॉस
Grass growing on the grass tennis court.	घास टेनिस कोर्ट पर बढ़ती जा रही है।
time stamp on the picture	तस्वीर पर समय की मुहर
two red metal springs	दो लाल धातु स्प्रिंग्स
a a block in a wall	एक दीवार में एक ब्लॉक
People looking to cross the road.	सड़क पार करते दिख रहे लोग।
the fair sky	निष्पक्ष आकाश
a motorcycle is parked in front of the road block	रोड ब्लॉक के सामने एक मोटरसाइकिल खड़ी है
White striped pedestrian cross-walk painted on street.	सड़क पर चित्रित सफेद धारीदार पैदल क्रॉस-वॉक।
Baseball team players in the dugout	डगआउट में बेसबॉल टीम के खिलाड़ी
boy sitting cross legged	क्रॉस लेग्ड बैठे हुआ लड़का
The man's hand forms a fist	आदमी का हाथ मुट्ठी बनाता है
stand of bamboo	बाँस का स्टैंड
Statue honoring members of the armed forces	सशस्त्र बलों के सदस्यों को सम्मानित करती हुई प्रतिमा
men of forces wearing the dress uniforms	वर्दी पहने बलों के पुरुष
Another stand and its owner	एक और स्टैंड और उसके मालिक
A man stand next to a jeep.	एक आदमी एक जीप के पास खड़ा है।
The sign that says Alice springs	ऐलिस स्प्रिंग्स कहने वाली संकेत
a sandwich on a block	एक ब्लॉक पर एक सैंडविच
red bags behind players feet	खिलाड़ियों के पैरों के पीछे लाल बैग
Asian characters on side of building	भवन के किनारे एशियाई अक्षर
The tennis player's shadow is on the tennis court.	टेनिस खिलाड़ी की परछाई टेनिस कोर्ट पर है।
fast looking yellow motorcycle	तेज दिखने वाली पीली मोटरसाइकिल
white springs under bed	बिस्तर के नीचे सफेद स्प्रिंग्स
a sponsors name on the tennis court wall	टेनिस कोर्ट की दीवार पर एक प्रायोजक का नाम
Asian characters written on a sign	एक संकेत पर लिखे गए एशियाई पात्र
the date and time indicating the time of picture	दिनांक और समय चित्र का समय दर्शाता है
The light forms a rainbow	प्रकाश एक इंद्रधनुष बनाता है
Headpiece of the second rider from the right	दाईं ओर से दूसरे सवार का सिर
postage stamp with liberty bell	डाक टिकट पर स्वतंत्रता की घंटी
Mud forms along the edge of the watering hole	पानी के छेद के किनारे मिट्टी के रूप में
an unfinished block of wood	लकड़ी का एक अधूरा ब्लॉक
green grass behind players	खिलाड़ियों के पीछे हरी घास
the second base coach watches the play	दूसरा बेस कोच खेल देखता है
child's soft fine brown hair	बच्चे के मुलायम महीन भूरे बाल
A black entertainment stand on wheels	पहियों पर एक काला मनोरंजन स्टैंड
fast motion image of woman walking in rain	बारिश में चलने वाली महिला की तेज गति की छवि
second story of building holds two balconies	इमारत की दूसरी मंजिल में दो बालकनियाँ हैं
ovan kept in the stand	स्टैंड में रखा ओवान
The speaker on the stand	स्टैंड पर मौजूद स्पीकर
a man in front of a produce stand	एक उत्पाद स्टैंड के सामने एक आदमी
a fast moving train	एक तेज़ चलती ट्रेन
tennis players shadow on court	कोर्ट पर टेनिस खिलाड़ी की छाया
date stamp on photo is 8/23/08	फोटो पर तारीख मोहर 8/23/08 है
a man sitting on a cement block	सीमेंट ब्लॉक पर बैठा एक आदमी
several baseball players in the dugout	डगआउट में कई बेसबॉल खिलाड़ी
An orange time stamp	एक नारंगी समय टिकट
the date is orange	खजूर नारंगी है
Grey block wall behind woman	महिला के पीछे ग्रे ब्लॉक दीवार
english muffin with egg and hollandaise	अंडे और hollandaise के साथ अंग्रेजी मफिन
tail of elephant forms a circle	हाथी की पूंछ एक चक्र बनाती है
plant is on a metal stand	संयंत्र एक धातु स्टैंड पर है
stand for trays	ट्रे के लिए स्टैंड
this is a blue court	यह एक नीली अदालत है
ginger with fair skin, orange hair, billions of freckles, and glasses	अदरक निष्पक्ष त्वचा, नारंगी बालों के साथ, अरबों झाई, और चश्मा
facial expression, particularly mouth that says, 'yeah, i'm fine w/ being a corporate drone	चेहरे की अभिव्यक्ति विशेष रूप से मुंह, जो कहती है, 'हां, एक कॉर्पोरेट ड्रोन मैं ठीक हूं'
white block on the street	सड़क पर सफेद ब्लॉक
boat forms ripples	लहर बनाती नाव
child forces straws into a a can	बच्चे एक कैन में जबरदस्ती स्ट्रॉ डालते हैं
Blue square on tennis court	टेनिस कोर्ट पर नीला स्क्वायर
the players tennis shoes are white	खिलाड़ी टेनिस जूते सफेद होते हैं
sign denoting 2900 block	2900 ब्लॉक को दर्शाते हुए हस्ताक्षर करें
books in a black stand	एक काले स्टैंड में किताबें
date and time of picture	तस्वीर की तारीख और समय
a train stop block	एक ट्रेन स्टॉप ब्लॉक
Snow covered cross walk	बर्फ से ढका क्रॉस वॉक
the steeple has a cross on top	स्टीपल के ऊपर एक क्रॉस है
Soccer players in action	फुटबाल खिलाड़ी एक्शन में
tennis court in bounds area for doubles play	युगल खेलने के लिए सीमा क्षेत्र में टेनिस कोर्ट
english word in green	हरे रंग में अंग्रेजी शब्द
Brown tennis court with white lines.	सफेद लाइनों के साथ ब्राउन टेनिस कोर्ट।
A brown stand next to a wall.	एक दीवार के बगल में एक भूरा स्टैंड।
black iron gate with white cross	सफेद क्रॉस के साथ काले लोहे का गेट
time stamp with red number	लाल नंबर के साथ समय टिकट
stack of books on bed stand	बेड स्टैंड पर पुस्तकों का ढेर
knife set in a wooden block	लकड़ी के ब्लॉक में चाकू सेट
base ball diamond with players	खिलाड़ियों के साथ बेस बॉल डायमंड
Television in the tv stand.	टीवी स्टैंड में टेलीविजन।
second green sign from the top	ऊपर से दूसरा हरा चिन्ह
Date stamp 6/30/2013	दिनांक मोहर 6/30/2013
logo on the tennis court	टेनिस कोर्ट पर लोगो
the necktie has a circle cross motif	नेकटाई में एक सर्कल क्रॉस मोटिफ है
a photographers stamp on the photo	फोटो पर एक फोटोग्राफर का मुहर
block of green water in front of surfer	सर्फर के सामने हरे पानी का अवरोध
asian characters in red	एशियाई वर्ण लाल में
A fine white sand	एक महीन सफेद रेत
night stand made of dark brown wood	गहरे भूरे रंग की लकड़ी से बना नाइट स्टैंड
two players in ground	मैदान में दो खिलाड़ी
brown mane on neck of second giraffe	दूसरी जिराफ की गर्दन पर भूरे दाग
white engraved cross	सफेद उत्कीर्ण क्रॉस
Red and silver sign with Asian characters	एशियाई अक्षर के साथ लाल और चांदी का चिह्न
Woman getting ready to cross street	सड़क पार करने के लिए तैयार हो रही महिला
press board table top	प्रेस बोर्ड टेबल टॉप
the train is a fast speed train	ट्रेन एक तेज गति वाली ट्रेन है
People at a fair.	एक मेले में लोग।
a metal cross beam	एक धातु पार बीम
players are playing baseball.	खिलाड़ी बेसबॉल खेल रहे हैं।
railed porch on the second floor of a home	एक घर की दूसरी मंजिल पर स्थित बरामदा
Balconies on the second floor	दूसरी मंजिल पर बालकोनी
a plate with white characters	सफेद पात्रों के साथ एक प्लेट
The players wear uniforms.	खिलाड़ी वर्दी पहनते हैं।
photographers watermark and date	फोटोग्राफरों वॉटरमार्क और तारीख
Red table with fast food above it	साथ रेड टेबल के ऊपर फास्ट फूड
woman cross her arms	महिला ने अपनी बाहों क्रॉस करते
The tracks cross here	यहां पटरियां पार हो जाती हैं
"orange ""do not cross"" sign"	"नारंगी ""पार नहीं करते"" संकेत"
A person standing at the food stand.	भोजन स्टैंड पर खड़ा एक व्यक्ति।
Three players are wearing helmet.	तीन खिलाड़ी हेलमेट पहने हुए हैं।
a non english sign	एक गैर अंग्रेजी संकेत
player running on court	कोर्ट पर दौड़ता हुआ खिलाड़ी
the woman on the court	अदालत में महिला
A round concert block	एक गोल कंसर्ट ब्लॉक
fast food items on plates	प्लेटों पर फास्ट फूड आइटम
Top window pane in the left corner of the second story window	दूसरी मंजिल विंडो के बाएं कोने में शीर्ष विंडो फलक
boundary lines on court	न्यायालय पर सीमा रेखाएँ
second wooden vertical slat from left	बाईं ओर से दूसरी लकड़ी की खड़ी स्लेट
A stand of trees along the edge of the lake	झील के किनारे पेड़ों का एक स्टैंड
a blue and white cross walk sign	एक नीला और सफेद क्रॉस वॉक साइन
open door of a second bus	एक दूसरी बस का खुला दरवाजा
floral box springs under mattress	मैट्रेस के तहत पुष्प बॉक्स स्प्रिंग्स
street sign advising of penalty	जुर्माने की सलाह देने वाली सड़क पर हस्ताक्षर
oranges and pears on the second layer of a fruit tree rack	एक फल के पेड़ की रैक की दूसरी परत पर संतरे और नाशपाती
A skier going down fast on a slope	ढलान पर तेजी से नीचे जा रहा एक स्कीयर
an english saddle above a saddle pad	एक काठी पैड के ऊपर एक अंग्रेजी काठ
four shadowy forms of giraffes seemingly looking forward	जिराफ के चार छायादार रूप प्रतीत होते हैं
dirty concrete wall behind players	खिलाड़ियों के पीछे गंदी कंक्रीट की दीवार
a couple of elephants photoshopped to stand out	हाथियों के एक जोड़े को फ़ोटोशॉप किया गया
The fast moving subway train	तेज गति से चलने वाली मेट्रो ट्रेन
the net between the two players	दोनों खिलाड़ियों के बीच नेट
Baseball glove on players left hand	खिलाड़ियों के बाएं हाथ पर बेसबॉल दस्ताने
silver and black french coffee press on shelf	चांदी और काले फ्रेंच कॉफी शेल्फ पर प्रेस
grey block in sidewalk	फुटपाथ में ग्रे ब्लॉक
short tan entertainment stand	लघु टैन मनोरंजन स्टैंड
A wooden block holding up the boat	नाव को पकड़े हुए एक लकड़ी का ब्लॉक
fence next to players	खिलाड़ियों के बगल में बाड़
Oranges on a fruit stand	एक फल स्टैंड पर संतरे
a butcher block with knives	चाकू के साथ एक कसाई ब्लॉक
Cluttered night stand	बरबाद नाइट स्टैंड
tan house with lighter colored second floor	हल्के रंग की दूसरी मंजिल के साथ तन घर
two white chairs on tennis court	टेनिस कोर्ट पर दो सफेद कुर्सियाँ
a cross railway sign	एक क्रॉस रेलवे साइन
a triangle forms on brick	ईंट पर एक त्रिकोण रूप
A fast boat with people in it	लोगों के साथ एक तेज नाव
People waiting to cross street.	सड़क पार करने का इंतजार करते लोग।
the button to press for the light is below the signal	प्रकाश के लिए संकेत के नीचे बटन को दबाएं
dirt ground elephants stand on	हाथी गंदगी के मैदान पर खड़े हैं
the springs on the motorcycle	मोटरसाइकिल पर स्प्रिंग्स
marked pedestrian cross walk	चिह्नित पैदल यात्री क्रॉस वॉक
The water is flowing fast	पानी तेजी से बह रहा है
The word AUG in the date	तिथि में AUG शब्द
wooden slat that forms back of bench.	बेंच की पीठ लकड़ी की स्लेट से बनती है।
the two male players are after the ball	दो पुरुष खिलाड़ी गेंद के पीछे हैं
power lines cross in the air	बिजली लाइनों हवा में आर-पार
area next to pot stand	पॉट स्टैंड के बगल का क्षेत्र
fast food in the backgrond	बैकग्रोनड में फास्ट फूड
this is a concrete yellow block	यह एक ठोस पीला ब्लॉक है
shadow on tennis court.	टेनिस कोर्ट पर छाया।
tennis court marked with white color	टेनिस कोर्ट सफेद रंग से चिह्नित
a green Christmas tree stand	एक हरे रंग का क्रिसमस ट्री स्टैंड
a business man waiting to cross the street	एक व्यवसायी व्यक्ति सड़क पार करने की प्रतीक्षा कर रहा है
A white stand mixer	एक सफेद स्टैंड मिक्सर
The time stamp is red.	समय की मोहर लाल है।
cross section of a broccoli stem	ब्रोकोली स्टेम के पार अनुभाग
players in the dugout.	डगआउट में खिलाड़ी।
a green fence at a tennis court	एक टेनिस कोर्ट में एक हरे रंग की बाड़
person playing tennis on the court	कोर्ट में टेनिस खेलने वाला व्यक्ति
Man trying to block the throwing of a frisbee	आदमी एक फ्रिसबी फेंकने को अवरुद्ध करने की कोशिश कर रहा है
the balcony on the second floor	दूसरी मंजिल पर बालकनी है
Red dragon fruit on a fruit stand.	फल स्टैंड पर लाल ड्रैगन फल।
person setting in second seat of bus	बस की दूसरी सीट पर बैठे व्यक्ति
The body of the stand up lamp.	स्टैंड अप लैंप का शरीर।
The players are male.	खिलाड़ी पुरुष हैं।
A fence at a tennis court	एक टेनिस कोर्ट में एक बाड़
the date says 7-1	दिनांक 7-1 कहता है
picture hanging in the wall with anime characters	एनीमे पात्रों के साथ दीवार में लटका चित्र
a grill press	एक ग्रिल प्रेस
Bird models suspended in shopping mall.	शॉपिंग मॉल में बर्ड मॉडल निलंबित।
green wall on tennis court	टेनिस कोर्ट पर हरी दीवार
Woman in an english style saddle	एक अंग्रेजी शैली की काठी में महिला
Photo date stamp	फोटो तारीख की मोहर
the copyright and date stamp of the photographer	फोटोग्राफर का कॉपीराइट और तारीख मोहर
a man stand on dock	एक आदमी डॉक पर खड़ा है
two players wearing white shorts	सफेद शॉर्ट्स पहने हुए दो खिलाड़ी
People on the court playing tennis.	कोर्ट पर लोग टेनिस खेल रहे हैं।
A blue fine on the surf board.	सर्फ बोर्ड पर एक नीला जुर्माना।
White potted flowers on the tennis court	टेनिस कोर्ट पर सफेद फूल खिले
a toasted english muffin	एक टोस्ट अंग्रेजी मफिन
Baseball player stealing second base	बेसबॉल खिलाड़ी ने दूसरा बेस चुरा लिया
a date stamp for 2010/02/07	2010/02/07 के लिए एक तारीख मोहर
second story of house	घर की दूसरी मंजिल
Blue cross window on second floor	दूसरी मंजिल पर ब्लू क्रॉस विंडो
bird characters on top of a brown cake	एक भूरे रंग के केक के ऊपर पक्षी के पात्र
a advertisement for highland springs	हाइलैंड स्प्रिंग्स के लिए एक विज्ञापन
the tennis court is made of grass	टेनिस कोर्ट घास से बना है
a line of runway models	रनवे मॉडल की एक पंक्ति
yellow numbers showing the date	पीले रंग की संख्या दिनांक दिखा रही है
A women skiing fast.	एक महिला स्कीइंग तेजी से।
cross country ski racers skiing up a hill.	क्रॉस कंट्री स्की रेसर एक पहाड़ी पर स्कीइंग करते हैं।
Three women soccer players sitting on a bench.	एक बेंच पर बैठी तीन महिला फुटबॉल खिलाड़ी।
decaying amazing building that looks like something between an aztec and buddhist shrine in the english countryside	अंग्रेजी देश में एज़्टेक और दोस्त तीर्थ के बीच कुछ की तरह लगने वाली अद्भुत इमारत का क्षय
A pot is fitted in a stand.	एक बर्तन को एक स्टैंड में फिट किया जाता है।
Safety railing on second story of building	इमारत की दूसरी कहानी पर सुरक्षा रेलिंग
Man sits floor cross legged	मैन फ्लोर क्रॉस लेग साइड बैठता है
White writing on a blue court.	नीली अदालत पर सफेद लेखन।
a very fast baseball	एक बहुत तेज बेसबॉल
White clock face with brown characters	भूरे रंग के पात्रों के साथ सफेद घड़ी चेहरा
buildings are behind the road block	सड़क ब्लॉक के पीछे इमारतें हैं
Young woman in grey sweatshirt hoping to block frisbee.	ग्रे स्वेटशर्ट में युवा महिला फ्रिसबी को ब्लॉक करने की उम्मीद करती है।
people on the second floor	दूसरी मंजिल पर लोग
a red dirt tennis court	एक लाल गंदगी टेनिस कोर्ट
Black block with number on it	उस पर नंबर के साथ ब्लैक ब्लॉक
stuffed disney characters	भरवां डिज्नी पात्रों
players waiting in dugout	डगआउट में इंतजार कर रहे खिलाड़ी
baseball players white pants	बेसबॉल खिलाड़ी सफेद पैंट
A motorcycle kick stand.	एक मोटरसाइकिल किक स्टैंड।
There is some fine sand here	यहाँ कुछ ठीक रेत है
a metal orange juice press	एक धातु संतरे का रस प्रेस
a baseball players uniform	एक बेसबॉल खिलाड़ियों की वर्दी
Three baseball players on baseball field.	बेसबॉल मैदान पर तीन बेसबॉल खिलाड़ी।
Booths at a street fair.	एक सड़क मेले में बूथ।
Back right foot of the second goat	दूसरे बकरे का पिछला दाहिना पैर
fine toothed blade of knife	चाकू के ठीक दांतेदार ब्लेड
guy's hand trying to block the camera	कैमरे को अवरुद्ध करने की कोशिश कर रहा आदमी का हाथ
Baseball in players right hand	खिलाड़ियों के दाएं हाथ में बेसबॉल
The second highest rail of the jump	छलांग का दूसरा सबसे बड़ा रेल
a white paper not in english	एक सफेद कागज अंग्रेजी में नहीं
green and white concession stand near umbrella	हरे और सफेद रियायत छाता के पास खड़े हैं
metal stand for ropes	रस्सियों के लिए धातु स्टैंड
an umbrella standing in a tennis court	एक टेनिस कोर्ट में एक छाता खड़ा है
there are english and Chinese characters	अंग्रेजी और चीनी अक्षर हैं
a bench along a tennis court	एक टेनिस कोर्ट के साथ एक बेंच
a young girl with a fair complexion	एक युवा लड़की एक निष्पक्ष संगति के साथ
The players uniform is white	खिलाड़ियों की वर्दी सफेद है
a motorcycle side stand	एक मोटर साइकिल साइड स्टैंड
The second clock showing on the tower.	टावर पर दिखने वाली दूसरी घड़ी।
tennis court floor	टेनिस कोर्ट का फर्श
cross on top of steeple	सीढ़ियों के ऊपर से पार
the players are on a field	खिलाड़ी एक मैदान पर हैं
the second car in the train	ट्रेन में दूसरी कार
A TV stand sitting under TV	टीवी के नीचे एक टीवी स्टैंड
two young softball players sitting on the bench	बेंच पर बैठे दो युवा सॉफ्टबॉल खिलाड़ी
man on a tennis court on a sunny day	एक धूप दिन पर टेनिस कोर्ट में आदमी
mass sheep and woolcraft fair ribbon	बड़े पैमाने पर भेड़ और ऊन का मेला रिबन
the combs are fine	कंघी ठीक हैं
cap on players head	खिलाड़ियों के सिर पर टोपी
the models are red and black	मॉडल लाल और काले हैं
Green and red tennis court	ग्रीन और रेड टेनिस कोर्ट
a celtic cross stone monument	एक केल्टिक क्रॉस स्टोन स्मारक
plants behind toy models	खिलौना मॉडल के पीछे पौधे
wave is moving fast	लहर तेज चल रही है
red double decker bus with Chinese characters and number 8	लाल डबल डेकर बस woth चीनी अक्षर और नंबर 8
this shop sells fine ales	यह दुकान बढ़िया एल्स बेचती है
orange street block	नारंगी सड़क ब्लॉक
cross section of fans at baseball game	बेसबॉल खेल में प्रशंसकों का क्रॉस सेक्शन
large soft drink cup from a fast food restaurant or store	फास्ट फूड रेस्तरां या स्टोर से बड़े शीतल पेय कप
red bananas at a fruit stand	एक फल स्टैंड पर लाल केले
train moving fast blurring image	ट्रेन तेजी से धुंधला छवि चलती है
this sign is not in english	यह संकेत अंग्रेजी में नहीं है
an apple cider press	एक सेब साइडर प्रेस
Black tv on top of brown stand.	ब्राउन स्टैंड के शीर्ष पर ब्लैक टीवी।
a hand moving too fast for the camera	एक हाथ कैमरे के लिए बहुत तेजी से आगे बढ़ रहा है
Starps on the stand.	स्टैंड पर तारे।
medium brown wood fine grained table	मध्यम भूरे रंग की लकड़ी ठीक दानेदार मेज
Back of court is green.	कोर्ट ऑफ बैक हरा है।
white trail that can only be made by incredibly fast planes	सफेद निशान जो केवल अविश्वसनीय रूप से तेज विमानों द्वारा बनाया जा सकता है
score card being held by a man on tennis court	टेनिस कोर्ट पर एक आदमी द्वारा आयोजित किया जा रहा स्कोर कार्ड
Man seated at food court table	मैन फूड कोर्ट टेबल पर बैठा
black cap on players head	खिलाड़ियों के सिर पर काली टोपी
sydney written in white letters on court	अदालत में श्वेत पत्र में लिखा गया sydney
fine whiskers on animal's chin	जानवरों की ठोड़ी पर ठीक मूंछ
a green chair on a tennis court	टेनिस कोर्ट पर हरी कुर्सी
Dollar amount of the penalty.	जुर्माना की डॉलर राशि।
Baseball catcher watching players	खिलाड़ियों को देखते हुए बेसबॉल पकड़ने वाला
white Arabic characters on sign	सफेद अरबी अक्षर
poster with cartoon characters	कार्टून पात्रों के साथ पोस्टर
A time date stamp in the corner	कोने में एक समय की तारीख मोहर
window planters outside second story	दूसरी कहानी के बाहर खिड़की बागान
green floor next to court	अदालत के आगे हरी मंजिल
The boy has a orange stamp on his hand.	लड़के के हाथ पर नारंगी मोहर है।
black mit in players hand	खिलाड़ियों के हाथ में काली घटा
cross next to the clock tower	क्लॉक टॉवर के बगल में स्थित है
sheep running really fast	भेड़ें बहुत तेज दौड़ रही हैं
advertising to the state fair is mounted on the lamp post	राजकीय मेले का विज्ञापन लैंप पोस्ट पर लगाया जाता है
bed pillow with cartoon characters on it	उस पर कार्टून पात्रों के साथ बिस्तर तकिया
tennis court being used in a match	एक मैच में टेनिस कोर्ट का इस्तेमाल किया जा रहा है
Knives in wood block	लकड़ी के ब्लॉक में चाकू
part of the ball field with players getting ready to play	खिलाड़ियों के खेलने के लिए तैयार होने के साथ गेंद मैदान का हिस्सा
the weather is fair	मौसम निष्पक्ष है
cement block siding on church	चर्च पर सीमेंट ब्लॉक साइडिंग
a man in the armed forces	सशस्त्र बलों में एक आदमी
The car is moving fast.	कार तेजी से आगे बढ़ रही है।
block wall behind giraffe head	जिराफ सिर के पीछे की दीवार
yellow stand	पीला स्टैंड
chinese characters are in the sign	चीनी अक्षर संकेत में हैं
the seat of the second motorcycle	दूसरी मोटरसाइकिल की सीट
Green part of a tennis court.	एक टेनिस कोर्ट का हरा हिस्सा।
the wave moves fast	लहर तेज चलती है
White second hand on the clock.	घड़ी पर सफेद दूसरा हाथ।
green colored material separating the court	हरे रंग की सामग्री अदालत को अलग करती है
The traffic lights stand out a lot.	ट्रैफिक लाइट बहुत बाहर खड़ी है।
fine stitching on leash	पट्टा पर ठीक सिलाई
Kick stand on a motorcycle.	एक मोटरसाइकिल पर किक स्टैंड।
An electronic display showing the date	एक इलेक्ट्रॉनिक डिस्प्ले जिसमें तारीख दिखाई गई है
cement block facade on a building	एक इमारत पर सीमेंट ब्लॉक मुखौटा
person forces cow to ramble over rocks for unknown reason	व्यक्ति अज्ञात कारणों से गाय को चट्टानों पर फेंकने के लिए मजबूर करता है
a cross walk across street white pattern	सड़क के पार सफेद पैटर्न पर एक क्रॉस वॉक
two lemons together on a block	एक ब्लॉक पर एक साथ दो नींबू
white teeth-like forms on top of wing	सफेद दांत जैसे पंख के ऊपर के रूप
date in red letters and numerals	लाल अक्षरों और अंकों में तारीख
empire near second base	दूसरे बेस के पास साम्राज्य
second place is wearing yellow	दूसरा स्थान पीला पहने हुए है
man in the middle of tennis court	टेनिस कोर्ट के बीच में आदमी
The second sign says 4 way.	दूसरा संकेत 4 तरह से कहता है।
five wheels on the court	कोर्ट पर पांच पहिए
Red T-shirt with white cross patch	सफेद क्रॉस पैच के साथ लाल टी-शर्ट
small white rocking chair with mother and child models in it	इसमें मां और बच्चे के मॉडल के साथ छोटी सफेद रॉकिंग कुर्सी
The comb is fine toothed.	कंघी ठीक दांतेदार है।
date stamp on the photo	फोटो पर तारीख की मोहर
Chinese characters on the sign	चिन्ह पर चीनी अक्षर
The sky is fair.	आसमान साफ ​​है।
a green court	एक हरी कोर्ट
a woman walking throw a trade fair	व्यापार मेला से गुजरती एक महिला
A crowd of people standing at the fair.	मेले में खड़े लोगों की भीड़।
a man standing on court	एक आदमी अदालत में खड़ा है
cross on a building	एक इमारत पर क्रॉस
the players shoes have spikes	खिलाड़ियों के जूते में स्पाइक्स होते हैं
A large brown block.	एक बड़ा भूरा ब्लॉक।
Man skiing fast	आदमी स्कीइंग तेजी से
the person has fair skin	व्यक्ति की त्वचा निष्पक्ष होती है
Skid foot marks on a tennis court	टेनिस कोर्ट पर स्किड फुट के निशान
a woman in a fair isle sweater	फेयर आइल स्वेटर में एक महिला
Shadow on the ground of the second racket from the left	बाईं ओर से दूसरे रैकेट की जमीन पर छाया
A backwards baseball hat on the players head.	खिलाड़ियों के सिर पर पीछे की तरफ वाली बेसबॉल टोपी।
a watermark and date	एक वॉटरमार्क और दिनांक
the toys are on the stand	खिलौने स्टैंड पर हैं
a second statue of a cow	एक गाय की दूसरी मूर्ति
large crack in tennis court	टेनिस कोर्ट में बड़ी दरार
The white ice models in the room.	कमरे में सफेद बर्फ के मॉडल।
hairy arm with fair pale skin	निष्पक्ष हाथ की त्वचा के साथ बालों वाली बांह
Paper on night stand	नाइट स्टैंड पर कागज
date stamp that reads 12/04/2010	दिनांक स्टैम्प जो 12/04/2010 को पढ़ता है
Yellow criss cross on the street by train.	ट्रेन से सड़क पर उतरता पीला क्रास।
base ball opponent players	बेस बॉल विरोधी खिलाड़ी
three baseball players playing a game	खेल खेलने वाले तीन बेसबॉल खिलाड़ी
The white bins on the second shelf of the fridge.	फ्रिज के दूसरे शेल्फ पर सफेद डिब्बे।
fine texture of feathers	पंख की ठीक बनावट
large orange and green sign giving name and date	बड़े नारंगी और हरे रंग का नाम और तारीख देते हुए
green cross on top of building	इमारत के शीर्ष पर हरे रंग की क्रॉस
colorful bus parked next to a stand and umbrella	रंगीन बस स्टैंड और छतरी के बगल में खड़ी है
a purple umbrella with little cartoon characters	बैंगनी कार्टून जिसमें छोटे कार्टून चरित्र हैं
the date is shown on the outter portion	तारीख को बाहरी भाग पर दिखाया गया है
fast moving ball towards home plate	तेजी से चलती गेंद घर की प्लेट की ओर
a fast food ordering bar	एक फास्ट फूड ऑर्डरिंग बार
The date 02/10/2009.	दिनांक 02/10/2009।
train going by fast	ट्रेन तेजी से जा रही है
date and time stamp	तारीख और समय टिकट
person has fair colored skin	व्यक्ति की त्वचा का रंग गोरा होता है
the copyright stamp on the photo	फोटो पर कॉपीराइट की मुहर
grey fine toothed comb	ग्रे ठीक दांतेदार कंघी
pizza on a butcher block table	कसाई ब्लॉक की मेज पर पिज्जा
gold Chinese characters on a red flag	लाल झंडे पर सोने के चीनी पात्र
The date stamp on the photo.	फोटो पर तारीख की मोहर।
red and white cross on man's shoulder	आदमी के कंधे पर लाल और सफेद क्रॉस
second bird is standing on car	दूसरा पक्षी कार पर खड़ा है
white lines painted on court	कोर्ट पर चित्रित सफेद लाइनें
A tennis court has snow on the surface	एक टेनिस कोर्ट में सतह पर बर्फ है
a metal stand under the seat of a bench	एक बेंच की सीट के नीचे एक धातु स्टैंड
a railing forms a corner sitting area	एक रेलिंग एक कोने के बैठने का क्षेत्र बनाती है
boy sitting cross-legged on ground	लड़का जमीन पर क्रॉस-लेग किया हुआ बैठा था
date and hotel that the photo was taken	तारीख और होटल कि तस्वीर ली गई थी
fine china with flower design	फूल डिजाइन के साथ ठीक चीन
green field next to players	खिलाड़ियों के आगे हरा मैदान
black metal cross-walk light	ब्लैक मेटल क्रॉस-वॉक लाइट
a lone spectator behind the tennis players	टेनिस खिलाड़ियों के पीछे एक अकेला दर्शक
the picture has a date stamp	तस्वीर में एक तारीख मोहर है
Calendar has star wars characters on it	कैलेंडर में इस पर स्टार वार्स कैरेक्टर हैं
spectator seats at a tennis court	टेनिस कोर्ट में दर्शक सीटें
a hard true tennis court	एक सच्चा टेनिस कोर्ट
Grate over a concrete block	एक कंक्रीट ब्लॉक पर पीसें
foreign characters on the vehicle's side	वाहन की तरफ विदेशी अक्षर
wood platform for bird to stand on	पक्षी के लिए लकड़ी का मंच
Woman going fast downhill.	तेज गति से जा रही महिला।
second floor windows	दूसरी मंजिल की खिड़कियां
second red and blue train	दूसरी लाल और नीली ट्रेन
White lamp shade on tall stand	लंबे स्टैंड पर सफेद लैंप की छटा
fast pass tickets on bus window	बस खिड़की पर तेजी से टिकट पास
an english style toilet	एक अंग्रेजी शैली का शौचालय
Large models in the park field	पार्क क्षेत्र में बड़े मॉडल
chair is decorated with Disney characters	कुर्सी को डिज्नी के पात्रों से सजाया गया है
knife on the chopping block	काट ब्लॉक पर चाकू
A bed of steel springs	स्टील स्प्रिंग्स का एक बिस्तर
this is a fast food place	यह एक फास्ट फूड जगह है
beige table lamp on stand	स्टैंड पर बेज टेबल लैंप
the tennis court	टेनिस कोर्ट
trunk of elephant forms a C	हाथी के सूंड से C बनता है
food on english muffin with yellow sauce	पीले सॉस के साथ अंग्रेजी मफिन पर खाना
This part of the court is blue	कोर्ट का यह हिस्सा नीला है
an attraction for a fair	एक मेले के लिए एक आकर्षण
blue box on tennis court	टेनिस कोर्ट पर ब्लू बॉक्स
black metal plant stand	काले धातु संयंत्र स्टैंड
the players hanging out in the dugout	डगआउट में बाहर घूमने वाले खिलाड़ी
Base of the yellow umbrella second from the left	पीले छतरी का आधार बाईं ओर से दूसरा है
the black fast forward arrow	काले तेजी से आगे तीर
Orange color night lamp with wooden stand	लकड़ी के स्टैंड के साथ नारंगी रंग का नाइट लैंप
line where block fit together	लाइन जहां ब्लॉक एक साथ फिट हो
bat stand in middle of bats	चमगादड़ के बीच में बल्लेबाजी
doilee stand is silver	डोली स्टैंड सिल्वर है
person on the court wearing black shirt	अदालत में काली शर्ट पहने व्यक्ति
different plane models are seen.	विभिन्न विमान मॉडल देखे जाते हैं।
Two press buttons of the sweater	स्वेटर के दो प्रेस बटन
Time and date stamp in corner	कोने में समय और तारीख मोहर
The stand of the t.v.	टी। वी। का स्टैंड।
sharp knife on the chopping block	चॉपिंग ब्लॉक पर तेज चाकू
second bird on right	दाईं ओर दूसरा पक्षी
woman wearing dress about to cross street	सड़क पार करने के बारे में पोशाक पहने हुए महिला
two motor cycle springs	दो मोटर साइकिल स्प्रिंग्स
a lava lamp on stand	स्टैंड पर एक लावा लैंप
black springs	काले स्प्रिंग्स
a mirror on a stand	स्टैंड पर एक दर्पण
green grass as tennis court	टेनिस कोर्ट के रूप में हरी घास
antique golf clubs and stand	प्राचीन गोल्फ क्लब और स्टैंड
wheels of train with springs	स्प्रिंग्स के साथ ट्रेन के पहिए
clear plastic French press	स्पष्ट प्लास्टिक फ्रेंच प्रेस
fine brown dirt	भूरे रंग की गंदगी
lifeguard stand is blue and white	लाइफगार्ड स्टैंड नीला और सफेद है
fast food	फास्ट फूड
a red cross on the paper	कागज पर एक लाल क्रॉस
a fast food meal served on a white plate	एक फास्ट फूड भोजन एक सफेद प्लेट पर परोसा जाता है
Dirt is on the baseball players outfit	बेसबॉल खिलाड़ियों के आउटफिट में गंदगी होती है
A cinder block wall.	एक सिंडर ब्लॉक दीवार।
Man playing tennis on purple and green tennis court.	मैन बैंगनी और हरे रंग की टेनिस कोर्ट पर टेनिस खेलता है।
Cartoon characters on his shirt	उसकी शर्ट पर कार्टून पात्र
black TV stand with flat screen	फ्लैट स्क्रीन के साथ ब्लैक टीवी स्टैंड
Some people are at the county fair	कुछ लोग काउंटी मेले में हैं
charger stand on a desk	चार्जर एक डेस्क पर है
security forces vehicle with open windows	सुरक्षा बल खुली खिड़कियों के साथ वाहन
Staircase leading to the second floor	दूसरी मंजिल की ओर जाने वाली सीढ़ी
a stand of snow covered trees	बर्फ से ढके पेड़ों का एक स्टैंड
Three different cellphone models	तीन अलग सेलफोन मॉडल
this is the cross	यह क्रॉस है
hedge bush growing outside of the tennis court	टेनिस कोर्ट के बाहर उगने वाली हेज बुश
a fine skateboard	एक बढ़िया स्केटबोर्ड
the trees in the tennis court	टेनिस कोर्ट में पेड़
wood cross	लकड़ी पार
a knife block on the shelf	शेल्फ पर एक चाकू ब्लॉक
line of trees to the left of the court	दरबार के बाईं ओर पेड़ों की कतार
surfer stand a surfboard	सर्फर एक सर्फ़बोर्ड खड़ा है
date book with plastic cover	प्लास्टिक कवर के साथ तारीख बुक
a stamp in the wood	लकड़ी में एक मोहर
yellow time and date stamp	पीला समय और तारीख मोहर
some kind of festival or fair	किसी प्रकार का त्योहार या मेला
gate/door to fence surrounding court	गेट / दरवाजे के आसपास बाड़ लगाने के लिए अदालत
The bench the players are sitting on.	खिलाड़ी जिस बेंच पर बैठे हैं।
Helmet on the second horse rider.	दूसरे घोड़े के सवार पर हेलमेट।
poles that block entrance by large vehicles	पोल जो बड़े वाहनों द्वारा प्रवेश को अवरुद्ध करते हैं
black shadow on baseball field beneath baseball players feet	बेसबॉल खिलाड़ियों के पैरों के नीचे बेसबॉल मैदान पर काली छाया
sign on brass stand	पीतल के स्टैंड पर साइन करें
Soccer players sitting on a bench	एक बेंच पर बैठे फुटबॉल खिलाड़ी
the second hand of the clock	घड़ी का दूसरा हाथ
A girl on the tennis court is preparing to hit the ball	टेनिस कोर्ट पर एक लड़की गेंद को हिट करने की तैयारी कर रही है
brick building on a city block	शहर के ब्लॉक में ईंट निर्माण
foul lines marking the court	अदालत को चिह्नित करने वाली बेईमानी लाइनें
A large screen with information about the players.	खिलाड़ियों के बारे में जानकारी के साथ एक बड़ी स्क्रीन।
part of a tennis court	एक टेनिस कोर्ट का हिस्सा
baseball players shoe	बेसबॉल खिलाड़ी जूता
a golden stand for the tub	टब के लिए एक सुनहरा स्टैंड
the trains are toy models	ट्रेन खिलौना मॉडल हैं
baseball bat in players hands	खिलाड़ियों के हाथों में बेसबॉल का बल्ला
person in black with a camera at the side of the court	अदालत के किनारे एक कैमरे के साथ काले रंग में व्यक्ति
press type electric cooking grill	प्रेस प्रकार इलेक्ट्रिक कुकिंग ग्रिल
Award for state fair pears	राज्य के निष्पक्ष नाशपाती के लिए पुरस्कार
players shorts are red	खिलाड़ी शॉर्ट्स लाल हैं
The sole of a second green shoe.	एक दूसरे हरे रंग के जूते का तलवा
the players uniform is green and white	खिलाड़ियों की वर्दी हरे और सफेद है
The yellow vase on the second shelf on the right.	दाईं ओर दूसरी शेल्फ पर पीला फूलदान।
a group of game officials at the corner of tennis court	टेनिस कोर्ट के कोने पर खेल अधिकारियों का एक समूह
large patch of grass next to fast food restaurant	फास्ट फूड रेस्तरां के बगल में घास के बड़े पैच
Silver springs on the side of bike.	बाइक के किनारे सिल्वर स्प्रिंग्स।
White copyright stamp	सफेद कॉपीराइट की मुहर
the word front on the sign in the english section	इंग्लिश सेक्शन में साइन पर सामने वाला शब्द
Chinese characters on the window	खिड़की पर चीनी पात्र
wide brown night stand	चौड़ी भूरा नाइट स्टैंड
cartoon characters on the bottle	बोतल पर कार्टून चरित्र
top glass block in wall	दीवार में शीर्ष कांच ब्लॉक
A stand with devices on it and wires behind it.	इस पर उपकरणों के साथ एक स्टैंड और इसके पीछे तारों।
Several forms of public transportation	सार्वजनिक परिवहन के कई रूप
second skateboard in picture	तस्वीर में दूसरा स्केटबोर्ड
really fast moving hand	वास्तव में तेजी से बढ़ रहा हाथ
blue television on stand	स्टैंड पर नीला टेलीविजन
The stand in the background with products the color white.	रंग सफेद उत्पादों के साथ पृष्ठभूमि में स्टैंड।
A big tv on a stand	एक स्टैंड पर एक बड़ा टीवी
group of cross country skiers	क्रॉस कंट्री स्कीयर का समूह
Screen of second laptop on desk	डेस्क पर दूसरे लैपटॉप की स्क्रीन
A time stamp	एक समय की मोहर
computer monitor on stand	स्टैंड पर कंप्यूटर मोनिटर
white forms on a keyboard	एक कीबोर्ड पर सफेद रूप
the court is made of sand	कोर्ट रेत से बना है
stone block building side	स्टोन ब्लॉक बिल्डिंग साइड
fence around the court.	अदालत के चारों ओर बाड़।
Blue scooter kick stand	नीला स्कूटर किक स्टैंड
small patch of grass beside a tennis court	एक टेनिस कोर्ट के पास घास के छोटे-छोटे टुकड़े
a fence between the field and players	मैदान और खिलाड़ियों के बीच एक बाड़
Sponsor signs hanging on the walls of the tennis court.	टेनिस कोर्ट की दीवारों पर प्रायोजक के निशान लटके हुए हैं।
Many stairs up to a second story.	कई सीढ़ियाँ एक दूसरी कहानी तक।
section of fine gray sand	महीन भूरे बालू का खंड
Blue, yellow and white stripes on players uniform.	खिलाड़ियों की वर्दी पर नीली पीली और सफेद धारियां।
