en	hi
a bunch of books on book stand##person,person,book,handbag,book,book	पुस्तक स्टैंड पर पुस्तकों का एक गुच्छा
gold religious cross on top of golden ball##clock,dog,person	स्वर्ण गेंद के शीर्ष पर स्वर्ण धार्मिक क्रॉस
Candle on glass candle stand##couch,cup,chair,wine glass,oven,bowl,potted plant,chair,vase,chair	कांच के मोमबत्ती स्टैंड पर मोमबत्ती
a blue wall beside tennis court##person,tennis racket	टेनिस कोर्ट के बगल में एक नीली दीवार
fine thin red hair##person,bench,vase,vase,frisbee	सूक्ष्म पतले लाल बाल
front springs of motocross motorcycle##person,motorcycle	मोटोक्रॉस मोटरसाइकिल के सामने स्प्रिंग्स
the tennis court is made up of sand and dirt##person,tennis racket,sports ball	य़ह टेनिस कोर्ट रेत और धूल से बना है
court attendant sitting in chair##person,person,chair,chair,chair,person,person,person,person,person	कुर्सी पर बैठे क़ोर्ट ऍटेंन्डेंट
a cross on the top of a spire##clock	एक शिखर के शीर्ष पर एक क्रॉस
the cross is black##person,bus,person,person,truck,car	क्रॉस काला है
press box on tennis court##person,person,person,person,person,person,person,person,person,backpack	टेनिस कोर्ट पर प्रेस बॉक्स
the characters are chinese##bus,car,person,traffic light,person,person,person,person,person,person	य़ह पात्र चीनी हैं
date and time of photo##sheep,sports ball	फोटो की तारीख और समय
Luggage sign in english and spanish##person,suitcase,suitcase,suitcase,suitcase,suitcase,suitcase,suitcase,suitcase,suitcase	सामान का चिह्न अंग्रेजी और स्पेनिश में
box springs on bottom of bed##bed	बिस्तर के तल पर बॉक्स स्प्रिंग्स
box springs with flower print##couch,bed,person,couch,book,handbag,chair,bed,bottle,chair	फूल के प्रिंट के साथ बॉक्स स्प्रिंग्स
fork under english muffin##bowl,carrot,spoon,carrot,carrot,dining table,cake,sandwich,carrot,carrot	अंग्रेजी मफिन के नीचे कांटा
there are two players in the court##person,person,tennis racket,tennis racket,tennis racket,tennis racket	क़ोर्ट में दो खिलाड़ी हैं
a man trying to cross##bus,bus,person,person,person,person,person,person,person,person	पार करने की कोशिश कर रहा एक आदमी
people on the second level##person,person,person,person,person,person,person,person,person,person	दूसरे स्तर पर लोग
Name and date stamp on picture##clock,refrigerator	तस्वीर पर नाम और तारीख की मोहर
A stand of trees.##frisbee,dog,dog	पेड़ों का एक झाड़।
umbrella to block sun##person,person,umbrella,person,chair,boat,dog,boat,person,kite	सूरज को अवरुद्ध करने के लिए छाता
the woman is waiting to cross the street##person,person,person,person,car,car,car,car,car,person	एक महिला सड़क पार करने के लिए इंतजार कर रही है
the lady appears to be going cross country skiing##person,person,person,backpack,backpack	महिला क्रॉस कंट्री स्कीइंग करती दिख रही है
White candle on a stand##clock,clock	एक स्टैंड पर सफेद मोमबत्ती
A grey rock wall forms a boundary of the enclosure##giraffe,zebra,zebra,person	एक ग्रे पत्थ क़ी दीवार बाड़े की एक सीमा बनाती हुई
a large block entrance##bicycle	एक बड़ा ब्लॉक प्रवेश द्वार
date when taken in yellow##cow,umbrella,umbrella,person,umbrella,person,person,umbrella,bench,umbrella	पीले रंग में लिया गया
tail of cat forms a C##cat,toilet,bottle,toilet,bottle,bottle	बिल्ली की पूंछ एक सी बनाती हुई
Wooden railing on second level##clock,couch,person,person,chair,dining table,person,chair,oven,couch	दूसरे स्तर पर लकड़ी की रेलिंग
white springs boxes and gears below train engine##train,person,person	सफेद स्प्रिंग्स बक्से और ट्रेन इंजन के नीचे गियर
time and date stamp on the photograph##carrot,carrot,carrot,carrot,carrot,carrot,carrot,carrot,carrot,carrot	तस्वीर पर समय और तारीख की मुहर
yellow fair pole on fence##person,person,baseball glove,tennis racket,car,bench	बाड़ पर पीला निष्पक्ष पोल
baseball players dressed in gray and orange##person,person,person,baseball glove,person,person,person,person,person,baseball glove	ग्रे और नारंगी रंग के कपड़े पहने हुए बेसबॉल खिलाड़ी
teal sign with white asian characters##tv,person,person,person,traffic light,person,person,person,person,person	सफेद एशियाई पात्रों के साथ चैती साइन
Chain-link enclosure for tennis court##person,sports ball,sports ball,sports ball,sports ball,sports ball,sports ball,sports ball,tennis racket	टेनिस कोर्ट के लिए चेन-लिंक संलग्नक
stand in the room##book,clock,book,book,book,book,book,book,book,book	कमरे में खड़े हो जाओ
The window on the right on the second floor.##person,person,person,car,bench,bench,bench,handbag,handbag,bench	दूसरी मंजिल पर दाईं ओर की खिड़की।
Date stamp of photograph##person,person	फोटोग्राफ की तारीख का मोहर
large silver juice press##person,person,cup,apple,apple,apple,apple,bottle,cup,cup	बड़े चांदी का रस प्रेस
the players in the dugout##person,person,person,person,baseball glove,person,person,person,car,person	डगआउट में खिलाड़ी
A white pot on the stand##person,person,chair,person,potted plant,person,person,person,person,chair	स्टैंड पर एक सफेद मटका
Photo's date stamp.##person,snowboard,person	फोटो की तारीख मोहर
hind leg forms one quadrant##cat	पिछ्ला पैर एक चतुर्थांश बनाता है
Light green tennis court##person,sports ball,tennis racket	हल्का हरा टेनिस कोर्ट
soccer players red shirt##person,person,sports ball,car,person	फुटबॉल खिलाड़ी की लाल शर्ट
Gray television on stand##potted plant,vase,book,book,laptop,vase,tv,book,book,book	स्टैंड पर ग्रे टेलीविजन
a second meal plate.##sandwich,sandwich,bowl,bottle,dining table,carrot	भोजन की एक दूसरी थाली।
dark wooden wash stand##bed,vase,chair,person	ग़ाढे रंग की लकड़ी का वाश स्टैंड
Cube-like cement block out-building with large square door##person,skateboard,bench,bench,person,person,person,bench,person,person	बड़े वर्ग द्वार के साथ घन-जैसा सीमेंट ब्लॉक ईमारत के बाहर
chinese characters on a red vehicle##person,cow,motorcycle,truck	एक लाल वाहन पर चीनी पात्र
blue tennis court area##person,tennis racket,tennis racket	नीला टेनिस कोर्ट क्षेत्र
Cement block outdoor flooring.##person,chair,person,person,chair,person,suitcase,person,person,bench	आउटडोर सीमेंट ब्लॉक फर्श।
the sign has asian characters##person,person,person,person,umbrella,person,umbrella,person,person,person	साइन में एशियाई वर्ण हैं
a cross sign on top of the tower##clock,clock	टॉवर के शीर्ष पर एक क्रॉस साइन
man is waiting to cross##car,car,traffic light,car,car,car,person,car,person,car	आदमी पार होने की प्रतीक्षा कर रहा है
spikes on a players shoe##person,person,person,person,baseball glove,sports ball,baseball glove	एक खिलाड़ी के जूते पर क़ीलें
a museum containing models of airplanes##airplane,airplane,person,airplane,person,airplane,person,airplane,airplane,person	एक संग्रहालय जिसमें हवाई जहाज़ों के मॉडलें हैं
date and time stamp on a picture##truck,car,truck,oven	एक तस्वीर पर तारीख और समय की मुहर
Chinese characters on sign##traffic light	चिन्ह पर चीनी अक्षर
an orange sign with written characters##car,person,person,person,person,car,car,person,person,person	लिखित अक्षरों के साथ एक नारंगी चिन्ह
Baseball players are in the background##person,person,baseball glove,person,person,baseball bat,person,person,person,person	बेसबॉल खिलाड़ी पृष्ठभूमि में हैं
Newspaper stand on the grass##car,car,truck,car,car,car,car,car,car,car	अखबार स्टैंड घास पर हैं
young female date wearing a purple rhinestone sleeveless gown##person,person,person,tie,potted plant,tie	एक बैंगनी स्फटिक स्लीवलेस गाउन पहनी हुई युवती
two people waiting to cross##person,person,traffic light,umbrella,car,person,car,fire hydrant,umbrella,handbag	पार करने हेतु इंतजार कर रहे दो लोग
the side of the second train##train	दूसरी ट्रेन का किनारा
the bird is stand on a tree branch##bird,bear	पक्षी एक पेड़ की शाखा पर खड़ा है
a black cross on a vertical stabilizer##person,airplane,person,tennis racket,backpack,cup,stop sign,person,potted plant	एक ऊर्ध्वाधर स्टेबलाइजर पर एक काला क्रॉस
a green tennis court##person,tennis racket,sports ball	एक हरी टेनिस कोर्ट
neutral makeup on both rain models##umbrella,person,person,umbrella,car,person,person,book,toothbrush,truck	दोनों वर्षा मॉडलों पर तटस्थ मेकअप
the second bus has a blue sign##bus,bus,person,person,person,car,car,person,bus,person	दूसरी बस में एक नीला चिन्ह है
This is some type of a fair.##person,person,person,dog,motorcycle,dog,person,person,person,person	यह किसी प्रकार का मेला है।
A display of different phone models##cell phone,cell phone,cell phone,cell phone,cell phone,cell phone,cell phone,cell phone,cell phone,cell phone	विभिन्न फोन मॉडलों का प्रदर्शन
microphone on the court##person,person	कोर्ट पर माइक्रोफोन
person doing a hand stand##laptop,laptop,laptop,person,book,book,person,person,keyboard,keyboard	व्यक्ति हाथों के बल खड़ा हुआ
springs of the seat##motorcycle,person,person,person,handbag,person,knife,motorcycle,clock	आसन की स्प्रिंग्स
A large pipe extending from the wall of the court.##person,tennis racket,potted plant,vase	कोर्ट की दीवार से निक्ली हुई एक बड़ी पाइप
rapid in fast water##person,surfboard	तेजी से पानी में
a stone block train platform##train,suitcase,person,person,person,person,person,person,train,train	एक पत्थर ब्लॉक का ट्रेन प्लेटफार्म
a book is on the night stand##bed	नाइट स्टैंड पर एक किताब है
orange springs on the bottom of train##train,person,person,traffic light,person,chair,chair,person	ट्रेन के तल पर नारंगी स्प्रिंग्स
a fast flowing river##bird	एक तेज बहने वाली नदी
lighted signs for different forms of public transportation##clock,clock	सार्वजनिक परिवहन के विभिन्न रूपों के लिए रोशन संकेत
three windows on the second floor##clock,potted plant	दूसरी मंजिल पर तीन खिड़कियां
a dark blue sedan moving fast##car,traffic light,traffic light,traffic light,traffic light,stop sign,tv,traffic light	एक गहरा नीला सेडान तेजी से बढ़ रहा है
zebras stand close together to watch for predators##zebra,zebra,zebra	ज़ेबरा शिकारियों को देखने के लिए एक साथ खड़े होते हैं
Gated street fair##car,person,person,person,person,person,person,person,traffic light,person	गेटेड स्ट्रीट फेयर
surfboard forms a splash of water##person,surfboard,person,surfboard	सर्फ़बोर्ड पानी के छींटे बनाता है
paper triangle stand##toilet,sink,toilet,cup,sink	कागज़ी त्रिकोण स्टैंड
a time and date stamp##traffic light,traffic light,traffic light,car,traffic light,car,traffic light	एक समय और तारीख क़ी मोहर
english letter is white##person,person,car,fire hydrant,handbag,person,handbag,umbrella,fire hydrant,person	अंग्रेजी अक्षर सफेद है
Brown box is on the tennis court##person,tennis racket,sports ball,sports ball,sports ball,sports ball,sports ball,chair,bench,bench	भूरा बॉक्स टेनिस कोर्ट पर है
a cross is on the tower##person,cow,cow,cow,cow,cow,cow,dog	मीनार पर एक क्रॉस है
players in dirt circle##person,person,person,baseball glove,baseball glove	मिट्टी के वृत्त में खिलाड़ी
beige stair way going to second level##potted plant	बेज सीढ़ी दूसरे स्तर तक़ जा रही है
grey concrete cross by the building##clock,clock	इमारत के बगल में ग्रे कांक्रीट क्रॉस
block for bench feet##bench,potted plant,potted plant,potted plant	बेंच के पैरों के लिए ब्लॉक
location characters are white##train	स्थान वर्ण सफेद हैं
Brown plastic fast food table##donut,bottle,dining table,remote,chair,car,chair,sandwich	ब्राउन प्लास्टिक फास्ट फूड टेबल
The TV and stand in the living room##couch,couch,chair,chair,chair,chair,chair,tv,chair,couch	लिविंग रूम में टीवी और स्टैड
brown wooden stairs leading to second floor##person,backpack,book,book,book,book,book,book,book,couch	दूसरी मंजिल तक जाने वाली भूरे रंग की लकड़ी की सीढ़ियाँ
very fine fabric and material##scissors	बहु उत्तम कपड़े और सामग्री
do not block intersection sign is above the right lane must turn right sign##bus,person,person,person,car,car,person,person,traffic light,person	चौराहे को ब्लॉक न करें सन्केत के ऊपर दाईं लेन को दाहिनी ओर मुड़ना चाहिए सन्केत है
The motorcycles are going fast##motorcycle,motorcycle,person,person,person,motorcycle	मोटरसाइकिलें तेजी से जा रही हैं
a fence behind the players##person,person,person,baseball bat,baseball bat	खिलाड़ियों के पीछे एक बाड़
the date on the photo##bear	तस्वीर पर तारीख
the penalty box is white lined##sports ball,person,person,person,person,person,person,person,person,person	सफेद लाइन से सीमांकित जुर्माना बॉक्स
the green sign with red and yellow characters##person,umbrella,person,umbrella,person,umbrella,person,umbrella,person,person	लाल और पीले वर्णों के साथ हरे रंग का चिह्न
A red metal frame forms the half pipe##person,skateboard	आधा पाइप बनाता हुआ एक लाल धातु का फ्रेम
shadows of players on court##person,person,tennis racket,car,person,person	कोर्ट पर खिलाड़ियों की छाया
a red tennis shoe on players foot##person,tennis racket,skateboard,person,person,person,skateboard	खिलाड़ी के पैर में लाल टेनिस का जूता
clock face on wall date##clock,clock,clock	तारीखी दीवार पर घड़ी का चेहरा
a group of people watching the baseball players##person,person,person,person,baseball bat,baseball glove,person,person,backpack,person	बेसबॉल खिलाड़ियों को देखने वाले लोगों का एक समूह
a woman on the opposite team trying to block the frisbee##person,person,person,frisbee	विपक्षी टीम की एक महिला फ्रिसबी को रोकने की कोशिश कर रही है
a white stand on road##car,car,car,car	सड़क पर एक सफेद स्टैंड
Concrete forms in pavement##person,person,bench,motorcycle,bench,potted plant,book,person,bench,book	फुटपाथ में काकंरीट की संरचनाएं
man standing next to fruit stand##person,person,person,person,clock,person,person,banana,banana,banana	फल स्टैंड के बगल में खड़ा आदमी
A bed plastic stamp##suitcase,bed	एक बिस्तर प्लास्टिक की मोहर
girl showing cow at fair##cow,person,person,bench,person,person,person,person,person,person	मेले में गाय दिखाती लड़की
judge on side of court on blue platform##person,person,person,person,person,person,tennis racket,person,person,clock	नीले मंच पर अदालत के पक्ष में न्यायाधीश
The top white cross.##cow,motorcycle,person,person,person,motorcycle,person,bicycle,person,cow	शीर्ष पर सफेद क्रॉस।
Dirt on the players pants.##person,person,baseball bat,person,person,baseball glove,person,person,person,person	खिलाड़ियों की पैंट पर मिट्टी।
chain-linked fence behind players##person,frisbee,person,person,person,person,person,person,person,person	खिलाड़ियों के पीछे चेन-लिंक बाड़
White paper on a black stand##couch,potted plant,vase,book,vase,chair	काले स्टैंड पर श्वेत पत्र
March 7th is the date on the calendar##book,sink,book,book,book,vase,cup,book,book	कैलेंडर पर 7 मार्च की तारीख है
Tray of white rice and english muffins##person,bowl,dining table,bowl,banana,spoon,spoon,dining table,spoon,bowl	सफेद चावल और अंग्रेजी मफिन की ट्रे
a iron stand on back##teddy bear,dog,bed	एक लोहे का स्टैडं पृष्ठ्भुमि पर
red hat on baseball players head##person,person,person,baseball glove,baseball bat,baseball glove,cup,cup,sports ball,baseball bat	बेसबॉल खिलाड़ी के सिर पर लाल टोपी
black and white tennis court netting##person,person,tennis racket,person,person,sports ball,person,chair,person,person	काले और सफेद टेनिस कोर्ट नेटिंग
second set of closed umbrellas##chair,chair,chair,chair,chair,person,person,chair,person,chair	बंद छतरियों का दूसरा सेट
Bright red semi-gloss block wall##toilet,toilet	चमकदार लाल अर्ध-ग्लोस ब्लॉक दीवार
Three baseball players are in the field.##person,person,person,baseball glove,baseball glove	तीन बेसबॉल खिलाड़ी मैदान में हैं।
A block wall is behind the skate park##person,skateboard,person	स्केट पार्क के पीछे एक ब्लॉक दीवार है
tail fine view of a red plane##airplane,airplane,person	एक लाल विमान की पूंछ का दृश्य
a group of ball players practicing##person,person,person,person,person,person,person,person,person,baseball bat	अभ्यास करने वाले गेंद खिलाड़ियों का एक समूह
a fine silver pocket watch##clock	चांदी की उत्तम जेब घड़ी
the date stamp in the corner of the pic##zebra,zebra,zebra,zebra,zebra,zebra,zebra,zebra,car,zebra	तस्वीर के कोने में तारीख की मोहर
Red circle with white cross under right wing##airplane	दक्षिणपंथी के तहत सफेद क्रॉस के साथ लाल सर्कल
a metal stand for the flowers##bowl,book,sink,potted plant,sink	फूलों के लिए एक धातु स्टैंड
A light reflecting on a tie press.##vase,suitcase,suitcase,refrigerator,bowl,oven,donut,cell phone,cell phone,suitcase	टाई प्रेस पर से प्रतिबिंबित होने वाला प्रकाश।
loose sediment forms on the rocks##bird,bird,bird,bird,bird,bird,bird,bird,bird,bird	चट्टानों पर ढीला तलछट बना हुआ
the hand is going to press a button##cell phone,person,person,dining table	यह हाथ एक बटन दबाने जा रहा है
sign written in english and foreign language##traffic light,potted plant	अंग्रेजी और विदेशी भाषा में लिखे गये सन्केत
yellow stamp date near bottom##person,person,person,remote,cup,donut,couch,donut,donut,donut	पीले रंग की तारीख की मोहर तल के पास
Street sign on a pole in english and chinese##stop sign	अंग्रेजी और चीनी में एक पोल पर मार्ग़ संकेत
an english muffin sandwich##cup,potted plant,sandwich,dining table,cup,bottle,vase,bottle,cat,chair	एक अंग्रेजी मफिन सैंडविच
many utility cables cross over the street##car,car,car,car,car,car,car	कई उपयोगिता केबल सड़क पर से जाते हुए
block sneakers with green laces##skateboard,bicycle,person,bicycle,bicycle,bicycle,bicycle,bicycle,bicycle,bicycle	ग्रीन लेस के साथ ब्लॉक स्नीकर्स
Brown painted signature and date.##person,horse,person	भूरे रन्ग में चित्रित हस्ताक्षर और तारीख
woman is behind the white line of a tennis court##person,person,person,person,person,person,person,sports ball,person,person	महिला टेनिस कोर्ट की सफेद लाइन के पीछे है
a sign showing cross streets##suitcase	एक संकेत चौराहा दिखा रहा है
farmer's market stand##broccoli,broccoli,broccoli,broccoli,carrot,broccoli,broccoli,broccoli,broccoli,broccoli	किसान के बाज़ार का स्टैडं
banana on the stand##bird,banana,banana,bird,bird,banana,banana,banana,banana,banana	स्टैंड पर केला
logo stamp on the door##refrigerator,suitcase,cup	दरवाजे पर लोगो की मुहर
english breakfast tea text##cup,book,book,book,person,clock,dining table,scissors	अंग्रेजी नाश्ता चाय पाठ
Black bike seat with silver springs.##banana,bicycle,banana,banana,person,banana,banana,banana,banana,banana	ब्लैक बाइक सीट सिल्वर स्प्रिंग्स के साथ।
white sign with blue asian characters on it##umbrella,person,car,stop sign,truck,car,car,car,traffic light	सफेद चिह्न नीले एशियाई वर्णों के साथ
Big springs on the bottom of train.##train	ट्रेन के निचले भाग पर बड़े स्प्रिंग्स
Small French coffee press.##person,wine glass,dining table,bowl,bowl,cup,cup,bowl,cup,cup	छोटा फ्रेंच कॉफी प्रेस।
Landline phone on the night stand##bed,clock,bed,remote,vase,remote,remote,remote	नाइट स्टैंड पर लैंडलाइन फोन
A tin container decorated with Star Wars characters and themes##vase,potted plant,apple,person	एक टिन का डब्बा स्टार वार्स पात्रों और विषयों के साथ सजाया हुआ
The players shoes are black.##person,baseball glove,sports ball,sports ball	खिलाड़ियों के जूते काले हैं।
Sis car models on top of each other##person,person,person,person,car,car,bench,handbag,airplane,car	एक दूसरे के ऊपर सिस कार की मॉडलें
date of the recording##motorcycle,person	रिकॉर्डिंग की तारीख
a second pizza in a pan##cup,pizza,pizza,pizza,cup,dining table,knife,bottle,bottle,fork	एक पैन में दूसरा पिज्जा
cross walk lines on street##person,car,traffic light,car,traffic light,traffic light	सड़क पर चलने के रेखाकिंत चिन्ह
two man standing on a tennis court##person,person,tennis racket,tennis racket	टेनिस कोर्ट पर खड़े दो शख्स
Cell phone is in stand.##mouse,laptop,tv,keyboard,book,book,cup,keyboard,keyboard	सेल फोन स्टैंड में है।
Blue section of tennis court##person,tennis racket,sports ball	टेनिस कोर्ट का नीला अन्श
A white plate with english muffins##sandwich,sandwich,dining table,bowl	अंग्रेजी मफिन के साथ एक सफेद प्लेट
A block in the wall.##motorcycle	दीवार में एक ब्लॉक।
a red sign advertising a fun fair##person,car,car,person,person,person,person,car,car,person	एक लाल सन्केत एक मजेदार मेले को विज्ञापित करते हुए
a cross on the front of a church##bus,person,bicycle,car,person,car,traffic light,car,truck,car	एक चर्च के सामने एक क्रॉस
the fence covered in netting at the end of the court##person,person,person,person,sports ball,sports ball,tennis racket,tennis racket,tennis racket,tennis racket	कोर्ट के अंत में जाल से ढ्का बाड़
Small section of baseline on a tennis court##person,person,sports ball,sports ball,tennis racket,tennis racket	एक टेनिस कोर्ट पर बेसलाइन का छोटा सा खंड
a platter of fine china##refrigerator,hot dog,bowl,cup,spoon,cup,spoon,cup,bottle,bottle	एक बढिया चीनी मिट्टी की थाली
Grey cross on a green dome top.##traffic light,car,car,car,car,car,car,car,car,car	एक हरे गुंबद के शीर्ष पर ग्रे क्रॉस।
fading on the court##person,person,person,person,person,person,person,person,person,person	कोर्ट पर मुरझाह्ट
The date 01/03/2008 in yellow.##person,handbag,person	दिनांक 01/03/2008 पीले रंग में।
information stamp on image##person,horse,person,person,person,person,person,horse,horse,person	छवि पर जानकारी की मुहर
yellow safety tape at a tennis court##person,person,person,person,sports ball,tennis racket,sports ball,sports ball,tennis racket,sports ball	एक टेनिस कोर्ट में पीला सुरक्षा टेप
Balconies on the second story of the buildings##motorcycle,motorcycle,person,car,motorcycle,person,car,car,person,person	इमारतों के दूसरे स्तर पर बाल्कनियाँ
Shades of the second biker##motorcycle,person,motorcycle,person	दूसरे बाइकर का छाया
a small black entertainment stand##laptop,couch,couch,remote,tv,dining table,keyboard,book	एक छोटा काला मनोरंजन स्टैंड
thumb press into a doughnut##donut,person,person	डोनट पे दबाव डालते हुए एक अंगूठा
The line on the tennis court is white.##person,tennis racket	टेनिस कोर्ट पर लाइन सफेद है।
mini hi-fi on small stand##laptop,tv,couch,book,book,cup,book,bowl,cup,book	छोटे स्टैंड पर मिनी हाई-फाई
two people stand next to the boat##bird,person,person,boat,boat,person,person,person,person,person	नाव के पास दो लोग खड़े हैं
an english taxi cab is on the bridge##clock,person,person,person,clock,person,person,car,person,car	पुल पर एक अंग्रेजी टैक्सी कैब है
white TV stand on floor##person,person,tv,person,remote,remote,book,remote,person	फर्श पर सफेद टीवी स्टैंड
cross that sits atop the column on the left side##clock	क्रॉस जो बाईं ओर के कॉलम के ऊपर है
Two baseball players at the plate##person,person,sports ball,baseball glove,baseball glove	प्लेट में दो बेसबॉल खिलाड़ी
photo date on right##motorcycle,car,car,car,car,car,car,person,person,car	फोटो की तारीख दाहिने ओर
a fine meal on a plate##broccoli,person,spoon,knife,spoon,dining table,sandwich,broccoli,fork	एक थाली में बढ़िया भोजन
a glass block window##person,book,book,tie,book,book,suitcase	एक ग्लास ब्लॉक की खिड़्की
time and date stamp on the picture##person,person,bed,person,dog	तस्वीर पर समय और तारीख की मुहर
sing is written in chinese and latin characters##person,car,potted plant	गाना चीनी और लैटिन अक्षरों में लिखा गया है
fine, pale sand##person,sports ball,person,person,kite	महीन, फीका रेत
cone of plane appears dark, shiny and fast##airplane,person,person	विमान का शंकु गहरे चमकदार और तेज दिखाई देता है
round light gray large cement block##frisbee,person,person,person,person,person,person,person,person,person	गोल हल्के धूसर रंग का बड़ा सीमेंट ब्लॉक
Large tv on black stand.##tv,potted plant,dining table,couch,book,oven	काले स्टैंड पर बड़ी टी.वी.
soccer players connect chin and forehead##person,person,sports ball,person	फुटबॉल खिलाड़ी ठोड़ी और माथा जोड़ते हुए
a round wooden block##vase,couch,potted plant,cake	एक गोल लकड़ी का ब्लॉक
a juice press##person,knife,person,orange,cup,person,cup,chair,orange,orange	एक जूस प्रेस
Railing on second floor of building##person,person,person,person,person,person,person	भवन की दूसरी मंजिल पर रेलिंग
white paper with pictures on stand on the table##chair,chair,dining table,potted plant,bottle,oven,chair,bottle,potted plant,dining table	मेज पर स्टैंड में चित्रों के साथ सफेद कागज
items for sale in stand##person,umbrella,person,umbrella,umbrella,umbrella,person,book,umbrella,chair	स्टैंड में बिक्री के लिए वस्तु
ridged metal pole stand to a large clock##clock	एक बड़ी घड़ी के लिए धातु का बना रिज पोल स्टैडं
Silver metal monitor stand##person,person,person,chair,chair,person,tv,kite,person,dining table	सिल्वर मेटल मॉनिटर स्टैंड
Landscape shrub models on display##truck,truck	प्रदर्शन पर लैंडस्केप झाड़ी मॉडल
these are baseball players##person,person,baseball glove,tennis racket,kite	ये बेसबॉल खिलाड़ी हैं
Cinder block base for fence##giraffe,giraffe,giraffe,giraffe	बाड़ के लिए सिंडर ब्लॉक बेस
A net in between the players##person,person,person,person,person,person,person,person,person,person	खिलाड़ियों के बीच एक जाल
the blue 28 on the back of the players shirt##person,person,baseball glove	खिलाड़ियों की पीठ पर नीले रंग की 28
the second level of the bus##bus,person,person	बस का दूसरा स्तर
characters on the billboard##person,person,person,umbrella,person,person,umbrella,person,umbrella,person	बिलबोर्ड पर अक्षर
The bolt underneath the springs.##bicycle,bicycle,person,bottle	स्प्रिंग्स के नीचे बोल्ट।
The net on a tennis court##person,person,tennis racket,tennis racket,sports ball,person,person,sports ball	एक टेनिस कोर्ट पर नेट
older dude on bicycle in a country where spanish/english are the official languages##person,stop sign,bicycle,car,traffic light,car,car,car,person,car	वृध व्यक्ति साइकिल पर एक देश में जहां स्पेनिश / अंग्रेजी आधिकारिक भाषाएं हैं
Several models hanging in the air in the exhibit##kite,kite,kite,kite,kite,kite,kite,kite,kite,kite	प्रदर्शनी में हवा में लटके कई मॉडल
black utensils in a wooden block##person,oven,cup,microwave,spoon,knife,bowl,dining table,cup,cup	लकड़ी के ब्लॉक में काले बर्तन
bird second in line##book,bird,bird,bird,bird,book	पक्षी दूसरी स्थान में
english flag printed umbrella##person,person,umbrella,person,person,umbrella,umbrella,umbrella,umbrella,umbrella	अंग्रेजी ध्वज मुद्रित छत्र
stamp on boy's left hand##person,person,teddy bear,teddy bear,person,person,sports ball,teddy bear	लड़के के बाएं हाथ पर मोहर
person holding a block of ice##cow,person,person,person,person,person	बर्फ का एक खंड पकड़े हुए व्यक्ति
large green and purple tennis court##person,person,person,tennis racket,person,bottle,tennis racket,person,chair,chair	बड़े हरे और बैंगनी टेनिस कोर्ट
A man taking a picture of the players.##person,person,person,chair,chair,person,tennis racket,chair,chair,chair	खिलाड़ियों की तस्वीर ले रहा एक आदमी।
Yellow time and date stamp##person,person,person,person,clock,person,person,handbag,bicycle,bicycle	पिली समय और तारीख मोहर
a fair weather cloud##truck,bus	एक उचित मौसम बादल
orange date print##person,person,person,person,person,person,person,backpack,person,person	नारंगी दिनांक प्रिंट
tennis players shaking hands##person,tennis racket,cell phone,person,person,person,person,person,chair,person	टेनिस खिलाड़ी हाथ मिलाते हुए
the block of hay##zebra,zebra,zebra,zebra	घास का ब्लॉक
there is a building behind the court##person,person,tennis racket,bench,bench,tennis racket,bench,bench,bench	कोर्ट अदालत के पीछे एक इमारत है
proprietor of the mobile lemonade stand##person,skateboard,person,person,person,car,car,umbrella,cell phone,cell phone	मोबाइल नींबू पानी स्टैंड के मालिक
pole behind second baseman##person,person,person,person,person,person,person,person,baseball bat,stop sign	दूसरे बेसमैन के पीछे पोल
Net separating a tennis##person,tennis racket,person,sports ball,person	एक टेनिस कोर्ट को अलग करते हुए नेट
A table full of fine china.##cake,vase,vase,vase,vase,vase,vase,vase,vase,cake	बढिया चीनी बर्तन से भरी एक मेज।
The items on the top shelf have painted characters on them##person,vase,vase,vase,vase,vase,donut,truck	शीर्ष शेल्फ पर वस्तुओं पे वर्ण चित्रित हैं
date palms on the grassy field##car	घास के मैदान में खजूर के पेड़
ground where bike stand##motorcycle,motorcycle,motorcycle,motorcycle,motorcycle,motorcycle,motorcycle,car,motorcycle,bicycle	जमीन जहां बाइक खड़े होते हैं
the players are wearing cleats on their shoes##person,person,person,person,person,baseball glove,baseball glove,person,chair,person	खिलाड़ी अपने जूतों में क्लीट्स पहने हुए हैं
green shrubbery that forms a circle around the pedestal##clock,clock,car,car,car,car	हरी झाड़ जो पेडस्टल के चारों ओर एक चक्र बनाती है
crosswalk for pedestrians to cross##person,person,person,person,umbrella,umbrella,person,backpack,car,person	पदयात्रियों के लिए क्रॉसवॉक
one side is in english##stop sign,traffic light	एक तरफ अंग्रेजी में है
The water bottle on the stand##bottle,person,suitcase,suitcase,oven,person,chair	स्टैंड पर पानी की बोतल
pair of hands typing fast on keyboard##tv,keyboard,person,book,chair	कीबोर्ड पर तेजी से टाइप करते हुए हाथों की जोड़ी
second level of building##clock,chair,chair,chair,chair,tv,chair,chair,bench	भवन का दूसरा स्तर
second man looking over first's shoulder##person,tie,person	दूसरा आदमी पहले आद्मी के कंधे पर से देख रहा है
The birds are flying fast##bird,bird,bird,bird,bird	पक्षी तेजी से उड़ रहे हैं
time stamp in corner of image##person,person,skis,snowboard,backpack,skis	छवि के कोने में समय की मोहर
light stand beside bed##bed,bed	बिस्तर के पास लाइट स्टैंड
date 01/05/2011##cat,tv	दिनांक 01/05/2011
this court is green##person,person,person,sports ball,person,person,sports ball	यह कोर्ट हरी है
a table filled with assorted models and tools##keyboard,train,bowl,keyboard,chair,dining table,bottle,bus	मिश्रित मॉडलों और उपकरणों से भरी एक मेज़
The cave the wave forms.##person,surfboard	गुफा रूपी तरंग ।
baseball players helmet##person,person,person,person,person,person,baseball bat,baseball glove,baseball glove	बेसबॉल खिलाड़ी का हेलमेट
Large cross outside of a church.##bus,person,person,person,bicycle,bicycle,person,person,person,bicycle	चर्च के बाहर एक बड़ा क्रॉस
fence on a baseball court##person,baseball bat,baseball bat,person,baseball bat,baseball bat,baseball bat,baseball glove,baseball bat,bench	एक बेसबॉल कोर्ट पर बाड़
large green bench press on the table##bottle,bottle,fire hydrant,oven,vase	मेज़ पर बड़ी हरी बेंच प्रेस
second car attached to train engine##train,train,train	ट्रेन इंजन से जुड़ी दूसरी कार
a white line cross walk.##horse,horse,traffic light,person,traffic light,person,traffic light,horse,traffic light,traffic light	एक सफेद लाइन क्रॉस वॉक।
expiration date in black ink##banana,banana,banana,banana,banana,banana,banana,banana,banana,banana	काली स्याही में समाप्ति की तारीख
box springs under a bed##person,person,bed,person	एक बिस्तर के नीचे बॉक्स स्प्रिंग्स
white graffiti on a stand##umbrella,cup,bottle,bottle,cup,bowl,bottle,bowl,potted plant	एक स्टैंड पर सफेद भित्तिचित्र
block behind the woman##person,cow,elephant,cup,cow	महिला के पीछे ब्लॉक
Glass safety rail on second floor.##clock,person,suitcase,suitcase,person,person,person,person,suitcase,suitcase	दूसरी मंजिल पर ग्लास सेफ्टी रेल।
White marking on the court##person,person,sports ball,sports ball,person,person,tennis racket,tennis racket,car,tennis racket	कोर्ट पर सफेद निशान
bolt on cross walk sign##traffic light,stop sign,scissors	क्रॉस वॉक साइन पर बोल्ट
a white line a cross the field##person,person,person,baseball bat,baseball glove	एक सफेद लाइन मैदान को पार करते हुए
players wearing knee-high socks##person,person,person,person,person,sports ball	खिलाड़ी घुटनों तक उच्च मोजे पहने हुए
second man skiing in snow##person,person,backpack,skis,skis,backpack,skis,skis	बर्फ में दूसरा आदमी स्कीइंग करता हुआ
a few people about to cross the road##traffic light,car,car,person,person,traffic light,person,person,car,car	सड़क पार करने जा रहे कुछ लोग
stop sign in english and farsi##stop sign	अंग्रेजी और फारसी में रुकने का सन्केत
a rounded edged wood block##bowl,bottle,pizza,dining table,bowl,bowl,bottle,bowl,bottle,pizza	एक गोल बढ़त वाला लकड़ी का ब्लॉक
Television set on wooden stand##person,tv,book,book,book,book	लकड़ी के स्टैंड पर टेलीविजन सेट
Four players standing on a tennis court##person,person,tennis racket,person,person,sports ball,bench,car,car	टेनिस कोर्ट पर खड़े चार खिलाड़ी
the tv stand is blacjk incolor##tv,person,cup	टीवी स्टैंड काले रन्ग का है
a team of good soccor players.##person,person,person,person,sports ball,person,sports ball,sports ball,frisbee,sports ball	अच्छे सॉकर खिलाड़ियों की एक टीम।
the angel is holding a cross shield##clock,person,person,clock,person	परी एक क्रॉस शील्ड पकड़े हुए है
a cross on the top of the building##clock	इमारत के शीर्ष पर एक क्रॉस
players watch from the dugout##person,baseball glove,person,person,baseball glove,person,person,person,person,person	खिलाड़ी डगआउट से देखते हुए
stand full of baseball fans##person,person,person,person,baseball glove,baseball bat,person,person,person,person	स्टैड्ं बेसबॉल प्रशंसकों से भरा हुआ स्टैड्ं
The cat is looking at the second cat.##cat,cat	एक बिल्ली दूसरी बिल्ली को देख रही है।
People with umbrellas waiting to cross the street.##person,umbrella,person,car,car,person,person,umbrella,umbrella,umbrella	छतरियों वाले लोग सड़क पार करने की प्रतीक्षा कर रहे हैं।
red ground of a tennis court##person,person,tennis racket,tennis racket,tennis racket,stop sign	एक टेनिस कोर्ट का लाल मैदान
the second hand on the clock##clock,sink,vase,person	घड़ी पर सैकडं का कांटा
the small cross on top of the headstone##	हेडस्टोन के ऊपर छोटा सा क्रॉस
White cross walk in road##traffic light,person,traffic light,car,bus,car	सड़क में व्हाइट क्रॉस वॉक
rusty springs beneath 'schwinn'##cat,bicycle,person,chair,person,bicycle	'श्विन' के नीचे जंग लगे स्प्रिंग्स
truck has two white Chinese characters##truck,bus,car,truck,car,car,truck,person,bus,car	ट्रक में दो सफेद चीनी अक्षर हैं
a bunch of baseball players waiting for their turn##person,person,person,person,person,person,person,person,person,train	अपनी बारी की प्रतीक्षा कर रहा एक बेसबॉल खिलाड़ियों का झुंड
The sign is in arabic and english##stop sign,boat,car,boat,boat,car,person	संकेत अरबी और अंग्रेजी में है
a copy of vanity fair is displayed##person,person,person,person,person,person,bottle,person,tie,person	वैनिटी फेयर की एक प्रति प्रदर्शित की गई है
the fine is 350 usd##car,person,car,car,car,car,truck,motorcycle,person	शूल्क 350 ड़ॉलर है
a black second hand##clock,car,car,traffic light	एक काला सैकंड का कांटा
A postage stamp.##laptop,mouse,book,book,dining table,bowl,keyboard,book,book,scissors	एक डाक टिकट।
advertisement on tennis court##person,tennis racket	टेनिस कोर्ट पर विज्ञापन
A fruit stand on the sidewalk##dog,parking meter,apple,apple,apple,apple,apple	फुटपाथ पर एक फल स्टैंड
fair large legion of anti-climate change, 350.org, kites with tails in the overcast sky##person,person,person,person,person,kite,kite,person,person,person	जलवायु परिवर्तन के उचित बड़े विरासत 350.org, आसमान में पतंगों के साथ पतंग
the banana hanging from the stand##banana,chair,clock,dining table,couch	स्टैंड से लटका हुआ केला
a church tower with a cross on the roof##person,person,person,bicycle,bicycle,car,person,bicycle,bicycle,person	छत पर एक क्रॉस के साथ एक चर्च टॉवर
Lid of glass cake stand##cake,dining table,wine glass	ग्लास केक स्टैंड की ढक्कन
member of opposing team trying to block the shooter's shot##person,person,person,person,person,person,person,person,person,person	निशानेबाज का शॉट ब्लॉक करने की कोशिश कर रहा विरोधी टीम का सदस्य
the stand is stable##person,microwave	स्टैंड स्थिर है
batter being poured into a waffle press##person,person,person,person,person,person,person,person,person,banana	बैटर को वफ़ल प्रेस में डाला जा रहा है
black metal fence behind a tennis court##person,tennis racket,person,person,person	एक टेनिस कोर्ट के पीछे काले धातु की बाड़
cross on the church roof##clock,person,person,person,person,person,person	चर्च की छत पर क्रॉस
block on the pole##clock	ध्रुव पर रोक
the second young lady is wearing capri-style jeans##person,person,dog,frisbee,potted plant,clock	दूसरी युवा महिला ने कैपरी स्टाइल की जींस पहनी हुई है
The blue tennis court##person,tennis racket	नीला टेनिस कोर्ट
Angels overlooking the cross##bench,bench,bench,person,bench,bench,bench,chair,bench,chair	क्रॉस को ऊपर से देखते हुए स्वर्गदूत
black Samsung tv on the tv stand##tv,person,book,book,book,book,book,book,book,book	टीवी स्टैंड पर काली सैमसंग की टीवी
Neon green time and date stamp##person	नियॉन ग्रीन में समय और तारीख की मोहर
the blue handle of a french press##cup,dining table,chair,sandwich,sandwich,dining table,cup	एक फ्रेंच प्रेस के नीले हैंडल
an alarm clock on the night stand##tv,bed,chair,potted plant,dining table,chair,bed,oven,dining table,dining table	नाईटस्टैंड पर एक अलार्म घड़ी
Dark colored stand a tv is on.##tv,chair,bottle,chair,bed,chair,chair,bottle,chair,bottle	गहरे रंग का स्टैंड एक जिसपर एक टीवी है।
second traffic light on pole##bicycle,traffic light,traffic light,traffic light,traffic light,traffic light,traffic light,traffic light,car,traffic light	पोल पर दूसरी ट्रैफिक लाइट
Old english writing on board##person,surfboard	बोर्ड पर पुरानी अंग्रेजी का लेखन
this is a coffee press##person,bottle,bowl,sink,knife,knife,bottle,spoon,cup,bottle	यह एक कॉफी प्रेस है
Green grass forms the ground.##kite,kite,kite,kite,person,kite,person,person,person,person	हरी घास ज़मीन पर।
sign laying on the second set of red apples##apple,apple,apple,person,apple,apple,apple,apple,apple,apple	लाल सेब के दूसरे सेट पर सन्केत रखा हुआ है
A sign in not english##person,person,person,person,person,handbag,orange,person,person,orange	सन्केत अंग्रेजी में नहीं है
black remote on the tv stand##tv,remote,remote,person,person,person,book,keyboard,book,person	टीवी स्टैंड पर काला रिमोट
Windows logo stamp on laptop.##laptop,bottle,cell phone,bottle,mouse,book,cell phone,book,book,book	लैपटॉप पर विंडोज की मोहर।
french press coffee maker on the table##laptop,person,person,laptop,potted plant,person,vase,chair,cup,couch	टेबल पर फ्रेंच प्रेस कॉफी मेकर
Black stand with microphone##person,tie,book,tie	माइक्रोफोन के साथ काली ब्लैक स्टैंड
little white english car with vertical oblong taillights##bus,traffic light,traffic light,bus,bus,person,person,person,person,car	लम्बाकार टेललाइट्स के साथ छोटी सफेद अंग्रेजी गाड़ी
aqua press wall with white advertising signs##person,person,person,person,banana,banana,person,person,banana,banana	सफेद विज्ञापन संकेतों के साथ एक्वा प्रेस की दीवार
Soccer players on field.##person,sports ball,person,person,sports ball,sports ball,person,sports ball,person,person	मैदान पर फुटबॉल खिलाड़ी।
Top of net on tennis court##person,tennis racket	टेनिस कोर्ट पर नेट का उपरी हिस्सा
Coming fast around the bend##motorcycle,person,person	मोड़ के पास तेजी से आते हुए
Blue border around tennis court##person,baseball bat,sports ball,backpack,chair	टेनिस कोर्ट के चारों ओर ब्लू बॉर्डर
ink stamp print##person,tie,person,person,person,person,tie,person,person,person	स्याही मोहर प्रिंट
yellow sticker with asian characters##car,car,car,truck,truck,car,car,traffic light,traffic light,truck	एशियाई अक्षरों के साथ पी्ली स्टीकर
second seat on motorcycle##motorcycle,person,car	मोटरसाइकिल पर दूसरी सीट
four female soccer players on a grassy field##person,person,person,sports ball,person,person,car	एक घास के मैदान पर चार महिला फुटबॉल खिलाड़ी
date 2008 printed on the label##bottle,wine glass,person,bottle,person,dining table,person	दिनांक 2008 लेबल पर मुद्रित किया गया है
grass tennis court##person,tennis racket,person,chair,person,person,person,person,person,person	घास का टेनिस कोर्ट
colored springs on truck##truck,truck,person,truck,truck,truck,truck,person,truck,person	ट्रक पर रंगीन स्प्रिंग्स
white cement block wall##toilet,skateboard	सफेद सीमेंट ब्लॉक की दीवार
a cats closed eye forms a slit##cat,couch	एक बिल्ली की बंद आंख सँकरी दरार बनाती हुई
the judge's chair by the court##person,person,person,tennis racket,person,person,person,person,person,person	कोर्ट के बगल में न्यायाधीश की कुर्सी
a white surfboard stand next to yellow one##surfboard,surfboard,surfboard,surfboard,surfboard,surfboard,skateboard,skateboard	एक सफेद सर्फ़बोर्ड स्टैडं के बगल में पीले सर्फ़बोर्ड
a layer of fine sweet chocolate##donut,donut,donut,donut,donut,donut,person,donut,donut	महीन मीठी चॉकलेट की एक परत
the watermark is a block font##traffic light,clock	वॉटरमार्क एक ब्लॉक फ़ॉन्ट है
red second hand on top of other hands##clock,horse,horse	लाल सैकडं कांटा दूसरे कांटो पर
long fine hairs on chin##horse,bear	ठोड़ी पर लंबे महीन बाल
Single white line drawn on tennis court##person,tennis racket	टेनिस कोर्ट पर खींची गई एक सफेद लकीर
a red cross decal##airplane,person,airplane	एक लाल क्रॉस डीकल
Blue garbage can on second floor.##person,person,person,person,cell phone,cup	दूसरी मंजिल पर नीला कचरे का डिब्बा।
front of military plane is pointed and fast##airplane	सैन्य विमान की नोख तीक्ष्ण और तेज़ है
signature of artist and date##horse,horse,banana,cow,bird,horse	कलाकार के हस्ताक्षर और तारीख
book of forms on desk##pizza,knife,pizza,pizza,pizza,pizza,person,pizza,pizza,pizza	डेस्क पर प्रपत्रों की पुस्तक
Silver french press coffee maker##cup,cup,chair,umbrella,chair,dining table,umbrella,spoon,chair,spoon	रजत फ्रेंच प्रेस कॉफी मेकर
orange date stamp on photo##giraffe	तस्वीर पर नारंगी तारीख की मुहर
woman in back of a court##person,tennis racket,person,bicycle	एक कोर्ट के पीछे महिला
the date of the picture##person,dining table,tie,bottle,book,sports ball	तस्वीर की तारीख
gray color on court##person,person,person,person,tennis racket,tennis racket,tennis racket,tennis racket,car,car	कोर्ट पर ग्रे रंग
small models boats on TV##tv,cup,potted plant,vase,person,skateboard,book,bowl,vase,book	टीवी पर छोटी मॉडल नावें
glass block privacy wall##chair,cup,tv,book,mouse,dining table,book,dining table,dining table,dining table	ग्लास ब्लॉक गोपनीयता दीवार
red painted lines on wooden court floor##person,person,tennis racket,tennis racket	लकड़ी के फर्श पर लाल चित्रित रेखाएँ
red cross with a white background##clock,clock	सफेद पृष्ठभूमि के साथ लाल क्रॉस
soccer players in a light blue uniforms##person,person,person,person,person,person,sports ball,person,person,person	हल्के नीले रंग की वर्दी में फुटबॉल खिलाड़ी
car moving incredibly fast##car,car,motorcycle	तेजी से बढ़ रही कार
a small dark brown night stand##bed,chair,book,dining table,laptop,book	एक छोटे से गहरे भूरे रंग के नाइट स्टैंड
a sign in a language that isn't English##	एक संकेत जो अंग्रेजी में नहीं है
silver and black French press coffee pot##cup,cup,cup,cup,bowl,dining table,chair,cup,cup,cup	चांदी और का्ले रन्ग का फ्रेंच प्रेस कॉफी पॉट
green bench on court##person,person,chair,tennis racket,person,sports ball,person,chair,cup,bench	कोर्ट में हरी बेंच
pendent on a fine chain##person,person,cake,person,cake,dining table,cake,chair,person	लटकन एक बढिया चैन पर
Paper forms on the table.##banana,sandwich,dining table	मेज पर कागज।
A ball girl at the back of a tennis court##person,person,person,person,chair,tennis racket,tennis racket,chair,person,person	एक टेनिस कोर्ट के पीछे एक बॉल गर्ल
Thick white wooden cross.##person,car,cell phone,bus,truck,car	मोटी सफेद लकड़ी का क्रॉस।
the second cushioned seat##chair,chair,chair,book,bench,book,book,book,book,book	दूसरी गद्दी वाली सीट
A black barrier stand.##person,person,tv,person,person,person,person,cell phone,person	एक काला अवरोधक स्टैडं।
green surface surrounding tennis court##person,tennis racket,person	टेनिस कोर्ट के आसपास की हरी सतह
Silhouette of tennis player on court.##person,person,person,chair,tennis racket,tennis racket,person,sports ball,tennis racket	कोर्ट पर टेनिस खिलाड़ी की पर्छाई।
black electric clock on night stand##vase,bed,bed,couch,couch,cell phone,cell phone,bowl	नाइट स्टैंड पर काली बिजली की घड़ी
a skate boarder going fast##person,skateboard,person,person,person,person,train,person,person	तेजी से जा रहा एक स्केट बोर्डर
5 cars of varying models parked on the street##stop sign,car,car,car,car,car,car,car,truck	सड़क पर खड़ी पांच विभिन्न मॉडलों की कारें
Signs on signpost naming streets and block numbers##	साइनपोस्ट पर सड़कों के नाम और ब्लॉक नंबर
big hairy fair laps##person,refrigerator,bottle,bottle,banana	बड़े बालों वाले गोरे गोद
white edge of white tennis court##person,person,tennis racket,sports ball,sports ball,tennis racket	सफेद टेनिस कोर्ट का सफेद किनारा
name and date in the corner##person,umbrella,person,person,boat,umbrella,person,person	नाम और तारीख कोने में
yellowish green grass over fine tan sand##horse,horse,horse	बारीक ताम्र रेत पर पीली हरी घास
small child cross country skiing##person,skis	क्रॉस कंट्री स्कीइंग करता हुआ छोटा बच्चा
a net divides the court##person,person,person,person,tennis racket,tennis racket,bottle,sports ball,person,sports ball	कोर्ट को विभाजित करता हुआ एक जाल
walking so fast person is captured as a blur##person,person,person,person,car,car,umbrella,person,umbrella,traffic light	बहुत तेजी से चल रहा ईन्सान एक धुंधले रूप में व्य्क्त हुआ है
the knife block is filled##oven,refrigerator,microwave,cup,spoon,spoon	एक चाकू का ब्लॉक भरा हुआ है
Long forks and springs##person,person,truck,person,car,motorcycle,truck,truck,chair	लंबे कांटे और स्प्रिंग्स
baseball players dressed in red and gray##person,person,person,person,baseball bat,person,person,person,chair,person	बेसबॉल खिलाड़ी लाल और धूसर रंग के कपड़ों में
second paper notice in a row##tv,suitcase	एक पंक्ति में दूसरा पेपर नोटिस
second story seating area##bus,dining table,dining table,chair,chair,chair,chair,chair,person,dining table	दूसरी मन्ज़ील पर बैठने की जगह
a cross country skier bending low##person,person,person,person,person,person,person,skis,skis,skis	नीचे झुकता हुआ एक क्रॉस कंट्री स्कीयर
Shadow running across a tennis court##person,tennis racket	एक टेनिस कोर्ट के पार जाती हुई परछाई
Coolers in front of the players.##person,person,person,baseball bat,person,person,baseball glove,person,sports ball,person	खिलाड़ियों के सामने कूलरें।
Cartoon characters on top of the building.##car,donut,person,person,person,cake,car,person,person,person	इमारत के शीर्ष पर कार्टून पात्र।
black lamp with floor stand##laptop,tv,keyboard,mouse,chair,keyboard,spoon,person	स्टैंड के साथ काला दीपक
Security officer making sure everyone is safe at the fair##person,person,bottle,person,person,person,person,person,person,person	सुरक्षा अधिकारी सुनिश्चित करते हुए कि सभी लोग मेले में सुरक्षित हैं
the springs are silver##motorcycle,person,handbag,person,person,person,person,handbag,truck,person	स्प्रिंग्स चांदी के रंग के हैं
sticker is blue+white and i think written in English+kanji##teddy bear,skis,kite	स्टिकर नीला + सफेद है और मुझे लगता है कि अंग्रेजी+कन्जि में लिखा गया है
a white sign not in English##person,boat,boat,boat,boat,potted plant,person,boat,boat,boat	एक सफेद चिह्न अंग्रेजी में नहीं
man working at stand##person,person,person,person,person,person,person,bus,umbrella,motorcycle	स्टैंड पर काम कर रहा आदमी
man standing in a tennis court##person,bench,car,car,tennis racket,bench,sports ball,person,traffic light	एक टेनिस कोर्ट में खड़ा आदमी
black band on players wrist##person,tennis racket,sports ball,person	खिलाड़ी की कलाई पर काली पट्टी
Name and date on the bottom right corner.##motorcycle,car,motorcycle,car,person,motorcycle,motorcycle,car,motorcycle,person	नीचे दाएं कोने पर नाम और दिनांक।
red second hand##clock	लाल सैक्डं कांटा
orange line on court##person,sports ball,person,bench,person,bench	कोर्ट पर नारंगी लकीर
date on the screen##cell phone,mouse,person,person	स्क्रीन पर तारीख
Baseball cap to block sun##person,sports ball,baseball bat,bench	सूरज को ब्लॉक करने के लिए बेसबॉल टोपी
a missing cider block opening to the outside##toilet,boat	बाहर की ओर खुलता हुआ एक लापता साइडर ब्लॉक
a cross on the top of the church##clock,traffic light,traffic light,car,traffic light,potted plant,car,traffic light,traffic light,traffic light	चर्च के शीर्ष पर एक क्रॉस
green grass by tennis court##person,person,tennis racket,tennis racket,bench,person,person	टेनिस कोर्ट के पास हरी घास
Some traffic is moving very fast##person,motorcycle,car	कुछ वाहन बहुत तेजी से आगे बढ़ रहे हैं
Large blue flag above the entire fair##horse,horse,horse,horse,horse,person,horse,person,horse,person	पूरे मेले के ऊपर बड़ा नीला झंडा
A crack on the court##person,person,person,person,person,tennis racket,tennis racket,person,tennis racket,tennis racket	कोर्ट में दरार
The tennis players arm extended.##person,tennis racket,sports ball,potted plant,chair,chair,person	टेनिस खिलाड़ी का हाथ बढ़ा हुआ।
concrete block near street.##truck,car,car,person	सड़क के पास कंक्रीट ब्लॉक।
Number of court on the wall.##person,tennis racket,tennis racket	दीवार पर कोर्ट की संख्या।
wooden sign with white letters on second bus##person,bus,person,person,person,person,person,person,person,person	दूसरी बस में सफेद अक्षरों के साथ लकड़ी का चिन्ह
exte stamp on yellow metal##train,train,person,bus,person,boat	पीली धातु पर exte स्टैम्प
tree root jutting out in jagged forms##bear	दांतेदार रूपों में उभ्रे हुए पेड़ की जड़
microphones are lined up on stand##person,person,person,person,person,person,tie,tie,person,person	माइक्रोफोन स्टैंड पर पंक्तिबद्ध हैं
the white cross on the flag##person,tennis racket,person,person,tennis racket	ध्वज पर सफेद क्रॉस
the yellow block in the parking stall##person,person,person,cup,bottle,cell phone,bottle,dining table,cup,baseball bat	पार्किंग स्टाल में पीला ब्लॉक
a sign that forms an X##traffic light,traffic light,traffic light,traffic light,traffic light,traffic light,traffic light,traffic light,traffic light,traffic light	एक चिन्ह जो X बनाता है
Land forms in the distance##person,person,skis	दूरी में भूभाग
playing on green and blue court##person,tennis racket,sports ball	हरे और नीले कोर्ट पर खेल
the sport is cross country##person,person,skis,skis	यह खेल क्रॉस कंट्री है
this wall forms a stall##sink,toilet	यह दीवार एक स्टाल बनाती है
A metal and stone column holding a bell and cross.##clock	एक धातु और पत्थर के स्तंभ एक घंटी और क्रॉस के आधार बनें हुए।
a tea set on a wooden stand##person,cup,vase,chair,cup,dining table,cup,bowl,cake,cup	एक लकड़ी के स्टैंड पर एक चाय का सेट
this is a press conference##person,person,tie,person,car,car,tie,person,person,car	यह एक प्रेस कॉन्फ्रेंस है
second airplane leaves smoke trail##airplane,airplane,airplane,airplane	दूसरा हवाई जहाज धुआँ छोड़ता हुआ
white characters on the street##person,person,stop sign,bicycle,potted plant,potted plant,bench,parking meter	सड़क पर सफेद अक्षर
people eating fast food##person,person,person,person,chair,person,person,chair,person,person	फास्ट फूड खाते हुए लोग
date in the corner##person,person,kite,kite,kite	कोने में तारीख
Silver cross necklace##person,tennis racket	चाँदी का क्रॉस हार
block of snow on a hill##person,person,person,person,person,skis,person,skis,skis,kite	एक पहाड़ पर बर्फ का ब्लॉक
a red and white county fair tent##person,skateboard,person,person,person,person,person,person,person,person	एक लाल और सफेद काउंटी मेले का तम्बू
long fine whiskers on a cat##cat,fork	एक बिल्ली पर लंबे सुक्ष्म मूंछ
man in a white hat on the tennis court##person,tennis racket,person,sports ball,sports ball,sports ball,sports ball,sports ball,sports ball	टेनिस कोर्ट पर एक सफेद टोपी पहने आदमी
a man in a yellow t-shirt sitting cross-legged##person,person,person,person,person,umbrella,person,person,person,person	पीले टी-शर्ट में एक आदमी पैर मोड़्कर बैठा है
long single block in row##banana	पंक्ति में एक लंबा खंड
Two fine drinking glasses##person,wine glass,person,person,wine glass,wine glass,person,wine glass,wine glass,bottle	दो बढिया ठीक पीने के गिलास
green baseball field with players on it##person,person,person,baseball bat,baseball bat,cell phone,cell phone,person	हरी बेसबॉल की मैदान खिलाड़ियों के साथ
Man stand in crane##traffic light,traffic light,truck,truck,car,car,car,car,car,car	आदमी क्रेन में खड़ा है
The characters 9F on the side of a plane##airplane	एक विमान के किनारे पर अक्षर 9F
English city bus on the road##bus	सड़क पर अंग्रेजी सिटी बस
the date is probably somehow, somewhat primitively digitally conveyed##clock,potted plant	तारीख शायद किसी तरह कुछ हद तक डिजिटल रूप से बताई गई है
blue plastic hot dog stand##fork,bottle,cup,cup,knife,dining table,hot dog,fork,cake,pizza	नीले प्लास्टिक का हॉट डॉग स्टैंड
A dirty white dish towel with red cross stripes##oven,laptop,bottle,refrigerator,cup,bottle	लाल क्रॉस धारियों के साथ एक गंदा सफेद डिश तौलिया
Two baseball players talking to each other##person,person,person,person,person,sports ball,baseball bat,baseball bat,chair,chair	बेसबॉल के दो खिलाड़ी आपस में बात करते हुए
long net across the court##person,person,sports ball,person,person,person,tennis racket	कोर्ट के आरपार लंबा जाल
a person cross country skiing in the background##person,person,person,skis,person,person,person,skis,person,car	पृष्ठभूमि में क्रॉस कटंरी स्कीइंग करता हुआ एक व्यक्ति
baseball players on field##person,person,person,person,sports ball,baseball glove,person,person,baseball glove,baseball glove	मैदान पर बेसबॉल खिलाड़ी
Yellow and black pole with a yellow cross.##train,person,train,traffic light,traffic light,traffic light,traffic light,train,train,train	एक पीले क्रॉस के साथ पीले और काले पोल।
A white box with a red cross.##toilet,sink,hair drier,cup	लाल क्रॉस के साथ एक सफेद बॉक्स।
Bread dough cross hatched design##oven,person,person,knife	ब्रेड आटा क्रॉस हैच डिज़ाइन
White boundary lines on the tennis court.##person,tennis racket	टेनिस कोर्ट पर सफेद सीमा रेखाएं।
waves forms behind the boat##boat,person,person,person,person,person	नाव के पीछे लहरें
second floor balcony##car	दूसरी मंजिल की बालकनी
fast food hot dogs and onion rings##person,hot dog,hot dog,cup,donut,dining table,donut,bowl	फास्ट फूड हॉट डॉग और प्याज के छल्ले
Time date stamp is bottom right##airplane,airplane,boat,airplane,boat	समय की तारीख की मोहर दाहिने नीचे है
12/22/2006 date stamp##person,book,book,book,book,book,book,chair,book,book	12/22/2006 तारीख की मुहर
fine grey gravel under players' legs##person,frisbee,person	खिलाड़ियों के पैरों के नीचे बारीक ग्रे बजरी
lamp stand light##bed,book,clock,book	दीपक स्टैडं की रोशनी
a professional tennis court##person,tennis racket,sports ball	एक पेशेवर टेनिस कोर्ट
Tall date palm##clock	ऊंचा खजूर
Dresser with dinosaur models on top##bed,potted plant,couch,clock	शीर्ष पर डायनासोर मॉडल के साथ ड्रेसर
top of tennis court##tennis racket,person,person,tennis racket,chair	टेनिस कोर्ट की जाली का ऊपरी हिस्सा
Woman dressed as a maiden at the fair##person,person,horse,horse,person,person,person,person,person,person	मेले में युवती की तरह कपड़े पहने महिला
characters apart on stage set##tv,person,remote,person,person,person,person,handbag,book,person	स्टेज सेट पर अलग से पात्र
Chinese characters on the back of the truck##car,truck,car,motorcycle,car,bus,person,car,traffic light,traffic light	ट्रक के पीछे चीनी अक्षर
fast blue and white train##person,train,tv,suitcase,handbag,person,person,car	तेज नीली और सफेद ट्रेन
players name on his shirt##person,person,person,baseball glove,person,person,baseball bat,baseball bat,person	खिलाड़ी के शर्ट पर उसक़ा नाम
College baseball players on the field.##person,person,person,person,baseball glove,person,person,person,person,person	मैदान पर कॉलेज के बेसबॉल खिलाड़ी।
blue court on the ground##person,sports ball,tennis racket	जमीन पर नीला कोर्ट
Two toasted English muffins on a plate.##bottle,cup,dining table,person,person,cup,cup,refrigerator,person,cup	एक प्लेट पर दो अंग्रेजी टोस्ट मफिन।
Bag on the cement block##bottle,sink	सीमेंट ब्लॉक पर थैला
flower on ice block##teddy bear,oven,person,train	बर्फ के ब्लॉक पर फूल
yellow tennis balls on court##person,tennis racket,sports ball,sports ball,sports ball,sports ball,sports ball,sports ball	कोर्ट पर पीली टेनिस की गेंद
A person waiting to cross the street##person,traffic light,traffic light,person,traffic light,car,car,potted plant,car,car	एक व्यक्ति सड़क पार करने की प्रतीक्षा में
tan colored brick block wall##traffic light,person,person	ताम्र रंग की ईंट ब्लॉक दीवार
A dark wooden cross with a small sign attached##stop sign,person,skateboard,dining table	एक छोटे संकेत के साथ एक लकड़ी का क्रॉस
A clock with cartoon characters on##person,person,person,person,clock,book,bird,book,book,book	कार्टून पात्रों के साथ एक घड़ी
rocky and rectangular block with openings on dirt##giraffe,giraffe,giraffe	चट्टानी और आयताकार छेद वाले ब्लॉक मिट्टी पर
adult on a tennis court##person,person,person,tennis racket,person,person,tennis racket,person,person,person	एक टेनिस कोर्ट पर वयस्क
Knives in a wooden block on the countertop.##refrigerator,oven,bowl,dining table,knife,orange,fork,knife,knife,knife	काउंटरटॉप पर एक लकड़ी के ब्लॉक में चाकू।
leg of the second person##person,bird,bird	दूसरे व्यक्ति का पैर
awning for food stand##cup,person,person,umbrella,person,person,person,person,person,person	फूड स्टैंड के लिए शामियाना
Knives in a wooden block behind the stove.##oven,knife,bottle,bottle,bottle,knife,bottle,bottle,microwave,knife	चूल्हे के पीछे एक लकड़ी के ब्लॉक में चाकू।
a red newspaper stand##car,car,car,traffic light,car,car,car	एक लाल अखबार स्टैंड
Brown block and white house with pitched black roof.##bus,person,person,person,person,bus,person,person	ब्राउन ब्लॉक और सफेद घर जिसमें काली छत है।
The train is traveling in fair weather##train,person,person,traffic light,train,traffic light,traffic light,person,person	ट्रेन उचित मौसम में यात्रा कर रही है
fast food on white plate##cup,hot dog,oven,dining table	सफेद प्लेट पर फास्ट फूड
air forces flag##airplane,truck,airplane	वायु सेना का झंडा
some watery plant forms##elephant,person,person,person,bench	कुछ गिले पौधे
curves of forms worn over shoes on snowboard##person,person,snowboard,snowboard,skis,skis,snowboard,bicycle,skis	स्नोबोर्ड पर जूतों के ऊपर पहने जाने वाले रूपों के वक्र
woman sitting on a stone block##person,suitcase,person,person,person,suitcase,bench,remote,person	पत्थर के ब्लॉक पर बैठी महिला
black lamb second from right##person,sheep,person,tie,sheep,sheep,dog,sheep,dog,dog	दाईं ओर से दूसरा का्ले भेड़ का बच्चा
blue wall of the court##person,tennis racket	कोर्ट की नीली दीवार
a wood night stand.##bed,bed	एक लकड़ी की नाईट स्टैंड।
the wall is cement block##train,person	दीवार सीमेंट ब्लॉक है
the court is dark blue##person,tennis racket,person,person,person,person,person	कोर्ट गहरा नीला है
The man's black shadow on the court##person,person,tennis racket,tennis racket,person,person,sports ball,person,person,person	कोर्ट पर आदमी की काली छाया
Woman standing on tennis court##person,tennis racket	टेनिस कोर्ट पर खड़ी महिला
a music stand on a curb##stop sign,person,person,car,person,person	एक वक्र पर एक संगीत स्टैंड
a weed growing up from the tennis court##person,sports ball,tennis racket,car	एक खरपतवार टेनिस कोर्ट से ऊग रहा है
The military plane has a cross on the tail.##airplane	सैन्य विमान की पूंछ पर एक क्रॉस है।
small food press on stove##donut,oven,pizza,donut,oven,cake,hot dog	स्टोव पर छोटा भोजन प्रेस
two bicyclists waiting to cross intersection##bicycle,traffic light,traffic light,person,traffic light,traffic light,car,traffic light,person,person	चौराहा पार करने का इंतजार कर रहे दो साइकिल सवार
cross nailed to a wall##person,person,tie,teddy bear,tie	कील से ठुकी हुई दीवार पर एक क़्रॉस
Wooden butcher block on kitchen sink.##oven,oven,sink,oven,oven,oven,bench	रसोई के सिंक पर लकड़ी का कसाई ब्लॉक।
three black Japanese characters##airplane	तीन काले जापानी वर्ण
microphone on angled stand##person,person,person,person,person,person,person,person,tie,person	एंगल्ड स्टैंड पर माइक्रोफोन
Look of concentration on game players face##person,person,remote,remote,remote,remote,couch,couch,chair,chair	खेल खिलाड़ियों के चेहरे पर दिखाई देती हुई एकाग्रता
blue cross on front of car##teddy bear,person,teddy bear,car,teddy bear,teddy bear,bicycle	कार के सामने नीली क्रॉस
the blue painted do not cross line on the train platform##train,train,person,person,person,person,person	ब्लू पेंट निषिद्ध करने हेतु लकीर ट्रेन प्लेटफॉर्म पर
tennis match in progress on outdoor court##person,person,tennis racket	आउटडोर कोर्ट पर टेनिस मैच चल रहा है
Two men on a tennis court playing tennis##person,person,tennis racket,tennis racket,tennis racket,sports ball	टेनिस खेलने वाले टेनिस कोर्ट पर दो आदमी
wood block of knives##bottle,wine glass,knife,knife,vase,microwave,wine glass,knife,person,remote	चाकू की लकड़ी ब्लॉक
A block of brown stones.##person,car,car,car,car,car,car,car,car,car	भूरे पत्थरों का एक ब्लॉक।
players' names in black on yellow background##person,person,sports ball,person,tennis racket,chair,tennis racket	पीले रंग की पृष्ठभूमि पर खिलाड़ियों के नाम
an off white set of box springs##person,bed,teddy bear,bottle,chair	बॉक्स स्प्रिंग्स का एक ऑफ व्हाइट सेट
Blue characters on a white background##laptop,book,book,cell phone,book,dining table	एक सफेद पृष्ठभूमि पर नीले वर्ण
TV on the stand.##person,person,chair,book,book,book,book,bottle,book,book	स्टैंड पर टी.वी.
Yellow ball on the court.##person,person,person,person,person,person,tennis racket,sports ball,tennis racket,tennis racket	कोर्ट पर पीली गेंद।
Electrical wire stand##traffic light,traffic light,traffic light,stop sign,traffic light,traffic light,kite	बिजली के तारों क स्टैंड
cross made of stone##person,person,person,bird,dining table,person,person,person,person,bird	पत्थर से बना क्रॉस
The traffic light has a red cross.##person,traffic light,train,person,person,person,person,person,person,person	ट्रैफिक लाइट में लाल क्रॉस है।
ball on a tennis court##person,sports ball,tennis racket,sports ball,sports ball,sports ball,sports ball,sports ball,sports ball	एक टेनिस कोर्ट पर गेंद
cross walk area painted on the street##traffic light,car,fire hydrant,traffic light	सड़क पर चित्रित क्रॉस वॉक एरिया
Brown stand holding bananas.##banana,banana,banana,banana,banana,banana,banana,banana,banana,banana	केले के साथ ब्राउन स्टैंड।
the line that shows foul or fair##person,person,baseball bat,baseball glove,person,person,person,person,person,person	रेखा जो बेईमानी या निष्पक्षता दिखाती है
Knob above knife block##person,oven,cup,tie,microwave,dining table,oven,knife,bowl,oven	चाकू ब्लॉक के ऊपर घुंडी
A time stamp on a video.##person,backpack,cell phone,backpack,bench,handbag,bench,potted plant	एक वीडियो पर समय की मोहर।
a clock on a glass stand##person,person,person,person,clock,person,person,person,person,person	एक ग्लास स्टैंड पर एक घड़ी
One person on the court##person,tennis racket,chair,person,person,person,person,person,person,person	कोर्ट पर एक व्यक्ति
Road block submerged by water##	पानी में डूबा रोड ब्लॉक
tennis court floor is blue##person,tennis racket,person,person	टेनिस कोर्ट की सतह नीली है
baseball players signing autographs##person,person,person,baseball glove,baseball glove,cell phone,person,potted plant,cell phone,person	हस्ताक्षर करने वाले बेसबॉल खिलाड़ी
fine metal safety netting##person,person,person,person,bench,baseball glove,person,person,baseball glove,person	बढिया धातु का सुरक्षा जाल
An audience witnessing a press conference##person,person,tv,person,tv,tv,person,laptop,person,tv	एक प्रेस कॉन्फ्रेंस के साक्षी बने दर्शक
players in team dugout##person,person,person,baseball bat,baseball glove,person,chair,chair,person,person	खिलाड़ी टीम डगआउट में
white frisbee in players hands##frisbee,person,person,person,person,umbrella	खिलाड़ियों के हाथों में सफेद फ्रिसबी
time and date stamp##car,car,car,car,truck,car,car,truck,truck	समय और तारीख की मोहर
A TV stand##tv,couch,chair,vase,bench,book,book,book,book,potted plant	एक टीवी स्टैंड
The time stamp display window on the meter on the left.##parking meter,parking meter,person,person	बाईं ओर मीटर पर टाइम स्टैम्प डिस्प्ले विंडो।
a wooden block of knives##knife,knife,knife,knife,knife,bowl,bowl,spoon,bowl,knife	चाकूओं का एक लकड़ी का ब्लॉक
a second story railing##truck,chair,person	एक दूसरे मन्ज़िल की रेलिंग
This is a picture of Chinese characters##person,person,person	यह चीनी पात्रों की एक तस्वीर है
fast super jet hovers in the sky##airplane	आकाश में घूमता हुआ तेज सुपर जेट
the players are moving##person,person,person,person,person,person,baseball glove,backpack,sports ball,baseball glove	खिलाड़ी आगे बढ़ रहे हैं
two guys in the background are observing the movements of the players##person,person,person,person,person,person,person,person,person,person	पृष्ठ्भूमी के दो लोग खिलाड़ियों की हरकतों को देख रहे हैं
Curled metal legs on a candle stand##person,person,bed,person,bowl	कैंडल स्टैंड पर धातु के घुमावदार पैर
two players watching the batter##person,person,person,baseball glove,person,person,person,baseball bat,person,person	बैटर को देखते दो खिलाड़ी
fine white spray against nose of craft##boat,surfboard	विमान की नाक पर सुक्ष्म सफेद स्प्रे
Brown tennis court floor##person,person,tennis racket,chair,chair,person,person,sports ball,person,person	भुरी टेनिस कोर्ट का फर्श
cross on top of church##person,bench,bench,person,chair,car	चर्च के शीर्ष पर क़्रॉस
copyright and date##bench,bench,bench,bench,bench	कॉपीराइट और दिनांक
A sign for the 550 west block of Bliss Ct.##	ब्लिस सीटी के 550 पश्चिम ब्लॉक के लिए एक संकेत।
Opponent Reaching Out to block##person,person,frisbee,person,person,person,person,person,person,person	विरोधी ब्लॉक करने की कोशिश करते हुए
Laptop on a stand##keyboard,laptop,mouse,cup,cup,person,tv,chair,person,tv	एक स्टैंड पर लैपटॉप
a wooden block sitting on the table##person,person,dining table,vase,bowl,book,bottle	टेबल पर एक लकड़ी का ब्लॉक
Part of the tennis court is green.##person,tennis racket,sports ball	टेनिस कोर्ट का एक हिस्सा हरा है।
two players in orange and white sitting on sidelines##person,person,person,person,person,person,person,person,person,person	किनारे पर बैठे नारंगी और सफेद में दो खिलाड़ी
date stamp of photo##cat,bowl,bowl,refrigerator	फोटो की तारीख मोहर
a pole of a lamp stand##potted plant,clock	एक दीपक स्टैंड की एक पोल
the door of second floor is brown##car,car,car,car,motorcycle,motorcycle,car,car,car,car	दूसरी मंजिल का दरवाजा भूरा है
Front wheel on second white truck.##stop sign,truck,car,potted plant	दूसरा सफेद ट्रक पर सामने का पहिया।
the second gold horse##horse,horse,horse,horse,umbrella,person,person,person	दूसरा सोने का घोड़ा
A small grey block on the median##clock,clock,bench,potted plant,fire hydrant	माध्यिका पर एक छोटा ग्रे ब्लॉक
Woman on a tennis court##person,tennis racket,sports ball	टेनिस कोर्ट पर महिला
red characters on top of blue building##	नीली इमारत के शीर्ष पर लाल वर्ण
the collar decoration of a fair isle type sweater##person,person,person,cake,dining table,chair,dining table,chair,person,cup	एक बढिया आइल प्रकार स्वेटर की कॉलर की सजावट
Woman wearing a cross on her neck##person,person,person,person,wine glass,wine glass,wine glass,person,wine glass,chair	महिला ने गले में क्रॉस पहना हुआ है
a colorful display lighted characters##clock,car,person,person,horse,person,person,person	रोशन पात्रों का एक रंगीन प्रदर्शन
The second train car##train,train	दूसरी ट्रेन की गाड़ी
the players arm is ready to throw##person,baseball glove	खिलाड़ी का हाथ फेंकने के लिए तैयार है
date and time stamp in corner##donut,donut,donut,dining table,donut,cake	कोने में तारीख और समय की मोहर
Two characters on the television##tv,chair,mouse,remote,person,chair,person,dining table,clock,keyboard	टेलीविजन पर दो किरदार
blue net around tennis court##person,tennis racket	टेनिस कोर्ट के आसपास नीला जाल
a block paved sidewalk##person,car,person,person,car,car,bicycle,person,bicycle,person	एक ब्लॉक फुटपाथ
a orange bottle in stand##toilet,bottle,sink,sink,chair,sink	स्टैंड में एक नारंगी बोतल
The items of the second rack##refrigerator,bottle,bottle,bottle,bottle,bottle,bottle,bottle,refrigerator,bottle	दूसरे रैक के आइटम
tan grey fine sand##person,surfboard,surfboard	ताम्र धूसर महिन रेत
fence in back of the court##person,tennis racket,apple	अदालत के पीछे बाड़
five glass vases on the stand##chair,potted plant,cup,cup,vase,dining table,chair,cup,book,bowl	स्टैंड पर पांच ग्लास के फूलदान
white Asian language characters painted on middle of street##person,person,bicycle,person,bicycle,bicycle,bicycle,person,bicycle,bicycle	सड़क के बीच में चित्रित किया गया सफेद एशियाई भाषा के अक्षर
second leaf from left##vase,potted plant,dining table	बाएं से दूसरा पत्ता
white fast logo in corner##person,snowboard	कोने में सफेद फास्ट की लोगो
a large concrete block##train,person	एक बड़ा कंक्रीट ब्लॉक
a player on second base##person,person,person,person,baseball bat,person,person,person,person,baseball bat	दूसरे बेस पर एक खिलाड़ी
fondant characters on cake##person,person,person,cake,cake,dog,cake,teddy bear,cake,cake	केक पर फोन्डेंट से बने पात्र
grey characters on a sign##	एक संकेत पर धूसर वर्ण
Red tie with Peanuts characters##person,tie,cat,couch,couch	मूंगफली के पात्रों के साथ लाल टाई
press here sticker on paw##teddy bear,teddy bear,teddy bear,teddy bear,teddy bear,teddy bear,teddy bear,teddy bear	"पंजा पर ""यहाँ दबाएं"" स्टिकर"
a sign in a zoo, written in catalan - spanish – english##person,elephant,giraffe,horse,person,person	एक चिड़ियाघर में एक संकेत जो साह - स्पेनिश - अंग्रेजी में लिखा गया है
White letters and numbers, indicating date and photographer.##airplane,airplane,truck,truck,truck,truck,truck,truck,car,truck	श्वेत पत्र और संख्या जो तिथि और फ़ोटोग्राफ़र को दर्शाते हैं।
window on second level##traffic light,traffic light,person,person,traffic light,person,person,person,person,traffic light	दूसरे स्तर पर खिड़की
yellow date and time stamp##person,snowboard,snowboard,person,person,person	पीला तारीख और समय टिकट
players playing base ball on field##person,person,person,baseball glove,person,sports ball	मैदान पर बेस बॉल खेलने वाले खिलाड़ी
a black fine tooth comb##knife,dining table	एक महिन काले दांत कंघी
a second daybed in room##suitcase,bottle,couch,bottle,backpack,cup,couch,bed,chair	दूसरे दिन कमरे में
lots of kick+grab marks on white wall below blurry words of graffiti [likely not in english]##person,skateboard,person,bicycle,bicycle,person,bottle,bicycle,person	भित्तिचित्रों के धुंधले शब्दों के नीचे सफेद दीवार पर बहुत सारे किक + हड़पने के निशान [अंग्रेजी में नहीं]
people enjoying themselves at the fair##person,person,donut,person,donut,person,person,donut,person,donut	लोग मेले में आनंद ले रहे हैं
bananas and oranges on fruit stand##orange,banana,banana,orange,banana,banana,orange,banana,banana,orange	फलों के स्टैंड पर केले और संतरे
A small food stand on wheels.##person,car,bus,car,person,car,car,car,person,person	पहियों पर एक छोटा भोजन स्टैंड।
fine china plate with gold rim##wine glass,dining table,bowl,carrot,carrot,carrot,carrot,carrot,carrot,carrot	सोने रिम के साथ महिन चीन प्लेट
a white alarm clock is on top of the night stand##bed,clock,sink	रात के स्टैंड के ऊपर एक सफेद अलार्म घड़ी है
baseball players sitting in dugout##person,person,person,person,person,person,person,person,person,backpack	डगआउट में बैठे बेसबॉल खिलाड़ी
letter on the wood block##scissors,suitcase,scissors,remote,suitcase	लकड़ी के ब्लॉक पर पत्र
Two butcher block knive sets.##person,dog,oven,bottle,bottle,bottle,bottle,microwave,bottle,bowl	दो कसाई ब्लॉक चाकू सेट।
A sideways rendered date stamp##laptop,remote,tv,book,keyboard,book,suitcase	एक बग़ल में तारीख की मुहर लगी
White second story porch##person,person,horse,horse,horse,horse,person,handbag	दूसरी सफेद कहानी पोर्च
a door on the side of the court##person,sports ball,tennis racket,sports ball	कोर्ट की तरफ एक दरवाजा
a block defining the space for the bench##bench	खंड के लिए स्थान को परिभाषित करने वाला एक ब्लॉक
block of white text##person,baseball bat,person,person,handbag,person,person,tv	सफेद पाठ का खंड
a brown cat is stand##cat,laptop,person,couch,person	एक भूरी बिल्ली खड़ी है
A train is going very fast##train,person,person,person	एक ट्रेन बहुत तेज चल रही है
Red and white Stop sign with characters in a non-English language##stop sign,stop sign,person,motorcycle,stop sign,stop sign,book	गैर-अंग्रेजी भाषा में वर्णों के साथ लाल और सफेद स्टॉप साइन
the shin guard on the players leg##person,sports ball,person,umbrella	खिलाड़ियों के पैर में पिंडली की रक्षा
A tennis player standing in the court##person,person,person,person,person,person,person,person,person,tennis racket	कोर्ट में खड़ा एक टेनिस खिलाड़ी
women waiting to cross##person,person,person,traffic light,traffic light,person,handbag,person,person,handbag	पार करने के लिए इंतजार कर रही महिलाओं
blue tennis court with painted white boundary lines##person,sports ball,tennis racket,baseball glove	नीले रंग की टेनिस कोर्ट जिसमें सफेद बाउंड्री लाइन है
white asphalt with fine lines##person,skateboard,bicycle,bicycle,potted plant,chair,bench,chair,bench	महिन लाइनों के साथ सफेद डामर
date the photo was taken##teddy bear,cat	तारीख फोटो ली गई थी
block of cheese on plate##oven,bottle,wine glass,refrigerator,pizza,dining table,spoon,chair	प्लेट पर पनीर का ब्लॉक
They both are playing on a tennis court.##person,tennis racket,person,tennis racket	वे दोनों एक टेनिस कोर्ट पर खेल रहे हैं।
leaves on tennis court##person,tennis racket,sports ball	टेनिस कोर्ट पर पत्ते
a cross street sign##traffic light,parking meter	एक क्रॉस स्ट्रीट साइन
the net across their court##person,person,tennis racket,person,person,person,person,person,tennis racket,sports ball	उनके दरबार में जाल
geyer springs street sign##stop sign	गीयर स्प्रिंग्स स्ट्रीट साइन
couple guys walking on tennis court##person,tennis racket,person,person,person,person,person,person,sports ball,tennis racket	टेनिस कोर्ट पर घूमते युगल
wooden cross hanging on a wall##bench,bench,chair,bench,bench,chair,chair,bench,bench,bench	एक दीवार पर लटका लकड़ी का क्रॉस
cross structures for bridge support##airplane,airplane,kite	पुल समर्थन के लिए क्रॉस संरचनाओं
boy standing on tennis court##person,person,tennis racket,tennis racket,car,car,tennis racket,handbag	टेनिस कोर्ट पर खड़ा लड़का
Banana shaped yellow banana stand##person,person,person,person,person,person,cup,person,person,banana	केले के आकार का पीला केला स्टैंड
A person below the date##clock,car,clock,car,person	तारीख से नीचे का व्यक्ति
green tennis court with white lines##person,person,person,person,person,person,person,person,person,person	सफेद लाइनों के साथ हरी टेनिस कोर्ट
man stand on skateboard##skateboard,person,person,remote,skateboard	आदमी स्केटबोर्ड पर खड़ा है
The front wheel of the second bus.##bus,bus,bus,bus	दूसरी बस का आगे का पहिया।
Bizarre sculpture on a coffee stand##chair,couch,couch,chair,cake,dining table	एक कॉफी स्टैंड पर विचित्र मूर्तिकला
large cement block##skateboard,person,person,person,person,skateboard,chair,person	बड़ा सीमेंट ब्लॉक
this stand is yellow in color##vase,vase,vase,vase,vase	यह स्टैंड पीले रंग का है
date stamp of scene##chair,refrigerator,chair,bottle,potted plant,microwave,bottle,bottle,oven,microwave	दृश्य का दिनांक टिकट
Propellers too fast to see.##airplane	देखने में बहुत तेज प्रोपेलर
a block, yellow, and white baseball uniform##person,baseball glove,person,person,person,baseball bat,baseball bat,car	एक ब्लॉक, पीला, और सफेद बेसबॉल वर्दी
players shoes are black, red, and white##person,baseball bat,person,person,baseball glove,person,person,person,person	खिलाड़ियों के जूते काले, लाल, और सफेद होते हैं
The players are giving a high five##person,person,person,baseball glove,person,person,person,person,person,person	खिलाड़ी उच्च पांच दे रहे हैं
person has a stamp on her hand##person,sheep,person,cell phone,dog,person,bench,person,person,cow	व्यक्ति के हाथ में एक मोहर है
Copy right date 2010##airplane	सही तिथि 2010 की प्रतिलिपि बनाएँ
low grey wall behind players##person,person,person,baseball bat,person,baseball glove,person,person,person,person	खिलाड़ियों के पीछे कम ग्रे दीवार
a green part of a tennis court.##person,frisbee	एक टेनिस कोर्ट का एक हरा हिस्सा।
the second street light##traffic light,traffic light,traffic light,traffic light,traffic light,traffic light,traffic light,traffic light,traffic light	दूसरी स्ट्रीट लाइट
Two tennis players standing together##person,person,tennis racket,tennis racket,person,truck	एक साथ खड़े दो टेनिस खिलाड़ी
two tennis players wearing black shorts##person,person,person,person,sports ball,sports ball,tennis racket,person,tennis racket,person	काले शॉर्ट्स पहने दो टेनिस खिलाड़ी
the players socks are blue##person,person,person,person,sports ball,person,person,person,person,person	खिलाड़ियों के नीले मोजे हैं
A red date stamp##person,person	एक लाल तारीख की मोहर
Monitor stand below monitor##tv,tv,keyboard,mouse,dining table	मॉनीटर स्टैंड के नीचे मॉनीटर
a manual press machine##person	एक मैनुअल प्रेस मशीन
long black pipe on display stand##umbrella,person,tv,bird	प्रदर्शन स्टैंड पर लंबे काले पाइप
male cross country skier##person,skis,skis	पुरुष क्रॉस कंट्री स्कीयर
models of airplanes on the tables##airplane,person,person,person,person,person,person,person,person,person	तालिकाओं पर हवाई जहाज के मॉडल
Man cross country skiing.##person,person,skis,bench,bench,person,car	मैन क्रॉस कंट्री स्कीइंग।
the sign has white characters##stop sign	साइन में सफेद अक्षर हैं
red time stamp on the photo##clock,car,clock,clock,truck,car,clock	फोटो पर लाल समय की मोहर
little girl standing on a tennis court##person,tennis racket	टेनिस कोर्ट पर खड़ी एक छोटी लड़की
man cross country skiing during race##person,person,person,person,person,skis,person,person,skis,person	दौड़ के दौरान आदमी क्रॉस कंट्री स्कीइंग
Cement forms sticking out of ground.##zebra,zebra,zebra,zebra,zebra,zebra,zebra	जमीन से चिपके हुए सीमेंट के रूप।
Sandwich on the second shelf.##chair,chair,chair,sink,dining table,chair,dining table,chair,bowl,donut	दूसरे शेल्फ पर सैंडविच।
the english muffins are toasted##sandwich,cup,bowl,sandwich,dining table,dining table	अंग्रेजी मफिन सिका हुआ हैं
yellow front of second train##train,train	दूसरी ट्रेन का पीला मोर्चा
models posing on motorcycle##person,person,person,person,person,motorcycle,car,car,car,handbag	मोटर साइकिल पर प्रस्तुत मॉडल
This open-air stand takes place in Jamaica##person,banana,banana,banana,bowl,banana,bottle,bottle,bowl,banana	यह ओपन-एयर स्टैंड जमैका में होता है
clear stand for controller##remote,book,remote,carrot	नियंत्रक के लिए स्पष्ट स्टैंड
black armed forces name on wing##airplane,airplane,airplane	काले सशस्त्र बलों के नाम विंग पर
second base found directly behind the pitcher##person,person,person,person,baseball bat,sports ball,baseball glove,baseball glove,baseball glove,baseball bat	दूसरा आधार सीधे घड़े के पीछे मिला
A cross on a tower.##clock,clock,boat	एक टॉवर पर एक क्रॉस।
picture taken at drive up fast food chain##person,motorcycle,person,car,car,car,car,car,backpack,truck	फास्ट फूड चेन ड्राइव पर लिया गया चित्र
two horses stand on hill##horse,horse	दो घोड़े पहाड़ पर खड़े हैं
cross centered in curved panels##bicycle,bicycle,person,motorcycle,person	घुमावदार पैनलों में क्रॉस केंद्रित है
white stripes in road is a pedestrian cross walk##traffic light,bus,person,car,person,traffic light,car,car,car,person	सड़क में सफ़ेद धारियाँ एक पैदल यात्री क्रॉस वॉक हैं
Box springs of bed.##bed	बॉक्स बिस्तर के स्प्रिंग्स।
The water bottle on the side of the court.##person,tennis racket,person,person,person,person,person,bottle,person	कोर्ट की तरफ पानी की बोतल।
A small wave forms on the water.##person,surfboard,person,person	पानी पर एक छोटी लहर बनती है।
a daytime picture of a couple cross country skiing##person,person,skis,skis,person	एक युगल क्रॉस कंट्री स्कीइंग की एक दिन की तस्वीर
Cars moving at a very fast speed##	बहुत तेज गति से चलती हुई कारें
a tree on a city block##person,car,truck,person,car,car,person,umbrella,person,person	एक शहर ब्लॉक पर एक पेड़
a cement block wall##person,frisbee	एक सीमेंट ब्लॉक दीवार
computer monitor on the stand##chair,keyboard,chair,tv,tv,person,mouse,mouse,person,bottle	स्टैंड पर कंप्यूटर मॉनिटर
snow on the trees at a cross-country ski race##person,person,person,person,skis,skis,person,person,parking meter,skis	एक क्रॉस-कंट्री स्की रेस में पेड़ों पर बर्फ
the second engine of the train##boat,train,train,boat,car	ट्रेन का दूसरा इंजन
a black music stand##chair,book,book	एक काला संगीत स्टैंड
chairs and tables on the side of the court##person,tennis racket,person,person,chair,tennis racket,chair,chair,kite,person	कोर्ट की तरफ कुर्सियां ​​और टेबल
Baseball travelling fast in the air##person,person,person,baseball bat,baseball glove,baseball bat,baseball glove,person,baseball glove,baseball glove	हवा में तेजी से यात्रा कर रहा बेसबॉल
fast food soda cups##remote,remote,couch,laptop,book,bottle,couch,dining table,cat,cup	फास्ट फूड सोडा कप
An old wooden stand shade##cow,umbrella	एक पुराना लकड़ी का स्टैंड शेड
red on players sleeve##person,baseball glove	खिलाड़ियों की आस्तीन पर लाल
a stand next to the sink##sink,bottle,bench,vase	सिंक के बगल में एक स्टैंड
second hand on clock##clock,chair	घड़ी पर दूसरा हाथ
four men on court##tennis racket,person,person,person,tennis racket,person,tennis racket,chair,chair,chair	कोर्ट पर चार आदमी
a block wall behind the man##person,motorcycle,cell phone,cell phone,tie	आदमी के पीछे एक ब्लॉक दीवार
cross walk at intersection##bus,person,person,car,car,traffic light,traffic light,handbag,person,car	चौराहे पर पैदल चलना
large tennis court##person,tennis racket,tennis racket	बड़े टेनिस कोर्ट
Child sitting cross-legged on the floor##cup,person,person,chair,chair,potted plant,dining table,chair,frisbee,chair	बच्चा फर्श पर क्रॉस-लेग किया हुआ बैठा था
Man standing on a tennis court##person,person,chair,sports ball,tennis racket,chair,car,person,chair,bottle	एक टेनिस कोर्ट पर खड़ा आदमी
yellow time date stamp##bus,car,car	पीले समय की तारीख मोहर
Turnstyle entrance to court##person,tennis racket	कोर्ट में टर्नस्टाइल प्रवेश
horse running fast with cowboy on the back##person,horse,person,person,person,person,person,person,person,person	पीठ पर चरवाहे के साथ तेजी से दौड़ता हुआ घोड़ा
blue umbrella pole held fast by sand##umbrella,umbrella,umbrella,umbrella,umbrella,boat,umbrella,umbrella,umbrella,boat	नीली छतरी वाला खंभा रेत से भरा हुआ
blue wood life guard stand##person,person,person,surfboard,surfboard,person,surfboard,frisbee,surfboard,person	नीली लकड़ी जीवन रक्षक स्टैंड
gloves are in the players back pocket##person,person,person,person,person,baseball bat,person,chair,bottle,chair	दस्ताने खिलाड़ियों की जेब में हैं
seats in the stand##person,tennis racket,person,person,person,sports ball,chair,chair,chair,chair	स्टैंड में सीटें
the players glove is black##person,baseball glove	खिलाड़ियों का दस्ताना काला है
a brown horse with an english saddle##horse,horse,person,person,dog,boat	एक अंग्रेजी काठी के साथ एक भूरे रंग का घोड़ा
The canvas sits on the stand##person,boat,kite,umbrella,backpack,boat,chair,suitcase,car,boat	कैनवास स्टैंड पर है
a camera on a stand##tv,traffic light,suitcase	एक स्टैंड पर एक कैमरा
net of the tennis court##person,person,tennis racket,tennis racket,car	टेनिस कोर्ट का जाल
man sitting in fruit stand##person,orange,banana,orange,orange,apple,banana,apple,orange,orange	फल स्टैंड में बैठा आदमी
grill press##hot dog,hot dog,hot dog,hot dog,hot dog,hot dog,hot dog,hot dog,hot dog,hot dog	ग्रिल प्रेस
cross on tower steeple##clock	टॉवर स्टीपल पर क्रॉस
ink stamp in the pencil box##book,cup,book,book,book,book,book,book,book,book	पेंसिल बॉक्स में स्याही मोहर
small table lamp on the night stand##bed,chair,chair,remote,dining table	नाइट स्टैंड पर छोटा टेबल लैंप
series of curved forms around body##zebra	शरीर के चारों ओर घुमावदार रूपों की श्रृंखला
a clock on a wooden block##clock	लकड़ी के ब्लॉक पर एक घड़ी
edge of a stamp##tennis racket,book,clock,vase,book,book,person,refrigerator	मोहर की किनारों
a man sitting cross legged in the grass##person,surfboard,surfboard,surfboard,surfboard,surfboard,frisbee,potted plant,sheep,bird	पार बैठे एक आदमी ने घास में पैर रखा
Right ear of the second cat##cat,cat,car	दूसरी बिल्ली का दाहिना कान
a fine bristled retractable brush##cup,toothbrush,bottle,cup,toothbrush,dining table,cell phone,apple,toothbrush	एक अच्छा ब्रिस्टल वापस लेने योग्य ब्रश
A motorcyclist driving very fast##motorcycle,person	एक मोटर साइकिल चालक बहुत तेजी से गाड़ी चला रहा है
a baseball players bat##person,person,person,person,baseball bat,baseball glove,person,person,person,person	एक बेसबॉल खिलाड़ी बल्लेबाजी करते हैं
A second sandwich on a wrapper.##cup,sandwich,sandwich,person,dining table,sandwich,spoon	एक रैपर पर दूसरा सैंडविच।
case with cross on it also has red trim##laptop,laptop,backpack,backpack,backpack,handbag,backpack,backpack,suitcase,bottle	इस पर क्रॉस के साथ लाल ट्रिम भी है
a railing on a second story balcony##person,umbrella,person,person,umbrella,person,person,person,bench,person	एक दूसरी बालकनी पर एक रेलिंग
Two soccer players##person,person,person,person,person,sports ball,person,person,person,chair	दो फुटबॉल खिलाड़ी
the cross on the top of the building structure##clock	भवन संरचना के शीर्ष पर क्रॉस
People waiting to cross street##car,traffic light,traffic light,person,car,car,car,person,car,car	सड़क पार करने का इंतजार करते लोग
characters on the sign##	संकेत पर अक्षर
A skateboard with asian characters painted on the underside##skateboard,bicycle,clock,bicycle,car,bicycle,truck,book	एशियाई पात्रों के साथ एक स्केटबोर्ड अंडरस्लाइड पर चित्रित
fine inscriptions on item##clock,scissors,scissors	मद पर ठीक शिलालेख
characters are posted in Chinese##train,clock	पात्रों को चीनी में पोस्ट किया जाता है
Man getting ready for a penalty kick##person,person,person,person,person,person,person,person,person,sports ball	मैन पेनल्टी किक के लिए तैयार हो रहा है
A red cross forms on the floor.##train,person	फर्श पर एक लाल क्रॉस रूपों।
many wires criss-cross overhead##	कई तारों को क्रॉस-ओवरहेड किया जाता है
This could be at a science fair.##person,clock,chair,clock,person,cup,chair,bottle,bicycle,person	यह एक विज्ञान मेले में हो सकता है।
man using a hand press to make juice##person,orange,orange,cup,cup,orange,orange,orange,orange,baseball bat	जूस बनाने के लिए हैंड प्रेस का उपयोग करने वाला व्यक्ति
The picture has a date stamp##potted plant,potted plant,potted plant,potted plant,potted plant,potted plant,potted plant,potted plant,potted plant,potted plant	तस्वीर पर तारीख की मोहर है
A date underneath a clock face##clock	एक घड़ी के चेहरे के नीचे एक तारीख
unfinished wood block under freezer##refrigerator,refrigerator	फ्रीजर के तहत अधूरा लकड़ी का ब्लॉक
fast train moving along track##train	ट्रैक के साथ चलती तेज ट्रेन
Three baseball players wearing white uniforms are in the background.##person,person,person,baseball glove,person,person,person,person,person,baseball glove	सफेद वर्दी पहने तीन बेसबॉल खिलाड़ी पृष्ठभूमि में हैं।
tennis player on the green colored section of a court##person,tennis racket,tennis racket	एक कोर्ट के हरे रंग के खंड पर टेनिस खिलाड़ी
making a very fast turn##person,person,skis,person,skis,person	बहुत तेज़ मोड़ देना
the tennis court net divides the court in the middle##person,person,tennis racket,tennis racket,person,person,person,person,sports ball,sports ball	टेनिस कोर्ट का जाल कोर्ट को बीच में बांटता है
4 players on the court##person,person,sports ball,person,tennis racket,person	4 खिलाड़ी कोर्ट पर
the chinese characters on the vase##cup,cup,vase,dog,potted plant,cup,vase	फूलदान पर चीनी अक्षर
crumbly english muffin bread##cup,sandwich,dining table	crumbly english मफिन ब्रेड
a stand with information##person,vase	जानकारी के साथ एक स्टैंड
ad on the wall of the court##person,person,tennis racket,person,person,person,person,person,potted plant,sports ball	अदालत की दीवार पर विज्ञापन
The right front window on the second level of the bus.##bus,car,person,person,person,person,bus,person,person,person	बस के दूसरे स्तर पर दाईं ओर की खिड़की।
the Asian characters are red##bus,car,traffic light,motorcycle,person,person,traffic light,person,person,person	एशियाई पात्र लाल हैं
block tower on top of hill##clock,clock	पहाड़ी की चोटी पर ब्लॉक टॉवर
The black baseball mit on the players hand##person,baseball glove,sports ball	खिलाड़ियों के हाथ पर काली बेसबॉल माइट
yellow cross on a tie##tie,tie,tie,tie,tie,tie,tie,tie	एक टाई पर पीला क्रॉस
five baseball players##person,baseball glove,person,person,person,person,person	पांच बेसबॉल खिलाड़ी
large date palm in the distance##giraffe,giraffe,person,person,person,person,person,person,person,person	दूरी में बड़ी खजूर
Cows laying down in the hay at a county fair##cow,cow,cow,person,person,person,person,person,person,person	काउंटी के एक मेले में गायों को लेटाया गया
armed forces identifying patch for US Army##person,bicycle,book,tv,book,tv,book,book,book,book	अमेरिकी सेना के लिए पैच की पहचान करने वाले सशस्त्र बल
The tennis court is two different colors.##person,tennis racket,car,sports ball	टेनिस कोर्ट दो अलग-अलग रंग हैं।
A indoor tennis court.##person,person,person,sports ball,tennis racket,clock,tennis racket,tennis racket	एक इनडोर टेनिस कोर्ट।
characters on the edge of the plate##cake,dining table,cake	प्लेट के किनारे पर अक्षर
a fruit stand with lots of fruits and vegetables##banana,banana,banana,person,banana,banana,teddy bear,banana,banana,banana	बहुत सारे फल और सब्जियों के साथ एक फल स्टैंड
red white and blue truck is at the fair##horse,person,horse,person,person,person,truck,person,truck,truck	लाल, सफेद और नीला ट्रक मेले में है
yellow date taken stamp##giraffe	पीली तारीख की मोहर
Tarp on the side of the court##person,tennis racket,person,person,person,person,person,person,person,person	कोर्ट की तरफ से तारप
Tall lights at the court##person,tennis racket,sports ball	कोर्ट में लगी लाइटें
players standing behind chain link fence##person,person,person,person,person,person,baseball glove,person,baseball bat,car	चेन लिंक बाड़ के पीछे खड़े खिलाड़ी
date stamp in the corner##bus,bus,bus,bus,bus,bus,bus,bus,bus,bus	कोने में तारीख मोहर
a cross in a church##potted plant,knife,knife,chair,chair,chair,chair	एक चर्च में एक क्रॉस
easel stand for painting##elephant,person,person,person,person,umbrella,elephant,bench,person,person	चित्र के लिए चित्रफलक स्टैंड
owners manual for a panini press##cup,sandwich,sandwich,dining table,apple	मालिकों के लिए एक पैनी प्रेस है
dog forms splashes in the water##dog,horse	कुत्ते ने पानी में छींटे मारे
two long and narrow panes below cross bar##cat	क्रॉस बार के नीचे दो लंबे और संकीर्ण पैन
Double red doors on second floor##clock,clock,refrigerator	दूसरी मंजिल पर डबल लाल दरवाजे
Partial view of second bus##bus,car,person,person,bus,person,person,person	दूसरी बस का आंशिक दृश्य
White door on second floor##dog,truck,car,person	दूसरी मंजिल पर सफेद दरवाजा
a romantic date night##person,person,bench,handbag,car	एक रोमांटिक मुलाक़ात की रात
knife block sitting on counter with knives in it##oven,sink,spoon,spoon,knife,sink,sink,refrigerator,knife	चाकू के साथ काउंटर पर बैठे चाकू ब्लॉक
a block of buildings##person,traffic light	इमारतों का एक ब्लॉक
Curved stairs on the approach to the court yard##potted plant	कोर्ट यार्ड की ओर जाने वाली घुमावदार सीढ़ियां
chinese characters on the side of a bus##person,person,person,person,bus,train,handbag	एक बस के किनारे चीनी अक्षर
blue tennis court##person,person,person,person,person,person,person,person,person,boat	नीला टेनिस कोर्ट
This person is waiting to cross the street##person,person,person,person,person,traffic light,car,person,person,person	यह व्यक्ति सड़क पार करने की प्रतीक्षा कर रहा है
The block for the post##bicycle,person,person,person,person,motorcycle,parking meter,handbag,sports ball	पद के लिए ब्लॉक
tan letters on the tennis court##person,sports ball,tennis racket	टेनिस कोर्ट पर टैन पत्र
this license plate has non-english characters##umbrella,person,car,car,handbag,car,handbag,chair,potted plant,potted plant	इस लाइसेंस प्लेट में गैर-अंग्रेजी अक्षर हैं
players uniform is black and gold##person,tennis racket,sports ball,sports ball,sports ball	खिलाड़ियों की वर्दी काले और सोने रंग की है
Watermark, showing copyright date.##airplane	वॉटरमार्क, कॉपीराइट दिनांक दिखा रहा है।
name and website of photographer and Chinese characters##person,person,person,person,person,person,cake,person,remote	फोटोग्राफर और चीनी पात्रों का नाम और वेबसाइट
tv on a stand##person,suitcase,couch,potted plant,suitcase,bowl,vase,bowl,dining table,couch	एक स्टैंड पर टी.वी.
grass grows next to the block##motorcycle	ब्लॉक के बगल में घास उगती है
A paper towel roll on a stand##person,tie,tie,bottle	एक स्टैंड पर एक पेपर टॉवल रोल
white springs under mattress##bed,bed	गद्दे के नीचे सफेद स्प्रिंग्स
The brick wall behind the court##person,person,person,person,tennis racket,sports ball,person,tennis racket	कोर्ट के पीछे ईंट की दीवार
egg shaped object on a stand##person,toothbrush,sink,bottle	एक स्टैंड पर अंडे के आकार की वस्तु
tennis ball shadow on the court##person,tennis racket,sports ball,tennis racket,frisbee	कोर्ट पर टेनिस बॉल की छाया
littleyiye photographers stamp##vase,vase,chair,potted plant,potted plant,dining table,vase	लिटिलिआ फोटोग्राफरों का टिकट
Picture stamped date 8/10/2013.##person,person,person,person,person,person,person,person,truck,person	चित्र मुद्रांकित दिनांक 8/10/2013।
2010 date in black##person,person,person,person,baseball bat,person,person,baseball bat,person,person	काले रंग में 2010 की तारीख
sign above the people at the fair##person,surfboard,person,person,person,person,person,person,person,person	मेले में लोगों के ऊपर दिखने वाला साइन
Straight fine black hair##person,tie,baseball glove	सीधे उत्कृष्ट काले बाल
a horse with an english saddle##horse,horse,horse,person,person,horse,person,person,person,person	एक अंग्रेजी सैडल के साथ एक घोड़ा
the baby has very fine hair##person,person,person	बच्चे के बाल बहुत अच्छे हैं
pelican forms ripples with legs##bird,kite,umbrella,bird	श्रोणि पैरों के साथ तरंग बनाता है
A window on a second story shop.##motorcycle,motorcycle,potted plant,potted plant	एक दूसरी कहानी की दुकान पर एक खिड़की।
Green stand in the snow.##person,skis,skis	बर्फ में हरा स्टैंड।
display models of cell phones##person,cell phone,cell phone,cell phone,cell phone,cell phone,cell phone,person,cell phone,parking meter	सेल फोन के प्रदर्शन मॉडल
black chinese characters n white sign##person,train,truck,person,bus,person	काले चीनी अक्षर और सफेद संकेत
Shadow of the man on the tennis court##person,tennis racket,sports ball,sports ball,sports ball,sports ball,sports ball,sports ball,sports ball	टेनिस कोर्ट पर आदमी की छाया
white marking on tennis court##person,tennis racket	टेनिस कोर्ट पर सफेद निशान
Baby fine light brown hair.##broccoli,person,bowl,broccoli,dining table,chair,person,cake,dining table	बच्चे की ठीक हल्के भूरे बाल।
the players lean on the fence##person,person,person,person,person,person,baseball glove,person,person,baseball bat	खिलाड़ी बाड़ पर झुक जाते हैं
second suitcase on bottom is orange##suitcase,suitcase,suitcase,suitcase,suitcase,person,suitcase,suitcase,umbrella,suitcase	नीचे दूसरा सूटकेस नारंगी है
Man helping child stand on snowboard##snowboard,person,person,person	स्नोबोर्ड पर खड़े होने में बच्चे की मदद कर कर रहा आदमी
extremely fast bullet train##train,train,person	बेहद तेज जाता बुलेट ट्रेन
Oriole on front of players hat##person,sports ball,baseball glove,person	खिलाड़ियों की टोपी पर ओरिओल
Net across the tennis court##person,person,person,person,tennis racket,person,person,person,person,person	टेनिस कोर्ट में नेट
second car parked on the street##car,car,car,car,car,car,traffic light,potted plant,train,traffic light	दूसरी कार सड़क पर खड़ी थी
Cather's mit for hand protection against fast pitches.##person,person,baseball glove,person,person,person,person,person,person,person	तेजी से पिचों के खिलाफ हाथ की सुरक्षा के लिए कैथरीन की माइट।
fast food chicken patty##sandwich,cell phone,bowl,dining table	फास्ट फूड चिकन पैटी
sunglasses of second rider##person,person,person,motorcycle,person,motorcycle,motorcycle,motorcycle	दूसरे सवार का धूप का चश्मा
People buying food on fast food store##person,person,pizza,pizza,person,person,person,cup,vase,knife	फास्ट फूड स्टोर पर खाना खरीदते लोग
second animal in the back##elephant,cow,potted plant,cow,potted plant	पीठ में दूसरा जानवर
the stand under the tv##tv,person,chair,couch,book,chair,bottle,refrigerator,chair,book	टीवी के नीचे खड़े हो जाओ
tennis court with white stripes##person,tennis racket,sports ball	सफेद धारियों वाला टेनिस कोर्ट
kick stand on motorcycle##person,person,person,motorcycle,motorcycle,person,person,motorcycle	मोटरसाइकिल पर किक स्टैंड
chainlink fencing forms a field exit##person,person,person,baseball bat,bench,sports ball,traffic light,person,baseball bat,baseball glove	चेनलिंक बाड़ लगाना एक क्षेत्र से बाहर निकलता है
Wall design of people characters.##person,tv,person,person,person,tv,person,person,person,person	लोगों के पात्रों की दीवार डिजाइन।
the sidewalk in front of the produce stand##person,person,person,orange,apple,apple,handbag,person,orange,orange	उपज स्टैंड के सामने फुटपाथ
concrete or cinder block walls##elephant	कंक्रीट या सिंडर ब्लॉक दीवारें
The tv stand is made of wood##tv,chair,chair,chair,dining table,chair,chair,dining table,book,chair	टीवी स्टैंड लकड़ी से बना है
the models perky lips##person,tie	मॉडल दिलेर होंठ
Three baseball players at first base##person,person,person	पहले बेस पर तीन बेसबॉल खिलाड़ी
block of black butcher knives##microwave,oven,knife,sink,knife,oven,sink,knife,oven,sink	काले कसाई चाकू के ब्लॉक
pointing sign in english and chinese##umbrella,person,person,person,umbrella,person,person,person,car,person	अंग्रेजी और चीनी में सांकेतिक संकेत
Lamp on the night stand to the left of the bed##bed,chair,tv	बिस्तर के बाईं ओर नाइट स्टैंड पर दीपक
Date stamp of March 16th, 2008##person,bus,train	16 मार्च 2008 की तारीख मोहर
coca cola international logo, written in english, probably repeated below##car,car,car,truck,car,person,car,person,person,person	कोका कोला अंतरराष्ट्रीय लोगो, अंग्रेजी में लिखा है, शायद नीचे दोहराया
a white sign with black Asian characters going vertically##motorcycle,person,person,person,person,person,person,motorcycle,handbag,car	काले एशियाई पात्रों के साथ एक सफेद लंबवत रूप संकेत
bicycle stamp on road##traffic light,traffic light,bus,car,person,person,traffic light,person,person,traffic light	सड़क पर साइकिल की मुहर
neon sign in a second floor window##person,car,car,person,car,car,person,car,person,car	दूसरी मंजिल की खिड़की में नीयन साइन
this couple is on a date##person,person,cup,cake,sink,chair,cup,cell phone,dining table,dining table	यह जोड़ी डेट पर है
Mcdonald's advertisement in a language other than english##traffic light,traffic light,train	अंग्रेजी के अलावा अन्य भाषा में मैकडॉनल्ड्स का विज्ञापन
rolls of towels on stand##sink,bottle	स्टैंड पर तौलिए के रोल
many glorious forms of opportunistic weeds##boat,boat	अवसरवादी मातम के कई शानदार रूप
kids at a fair eating##person,pizza,person,person,person,car,person,pizza,person,person	बच्चे मेले में खा रहे हैं
a block lower half of a wall##giraffe,giraffe	एक दीवार के निचले आधे हिस्से को ब्लॉक करें
jelly jar on top of a chopping block##bottle,bottle,knife,dining table,knife,hot dog,knife,sandwich	एक काट ब्लॉक के शीर्ष पर जेली जार
yellow poles by the cross sign##train,traffic light,traffic light,traffic light,traffic light,traffic light	क्रॉस साइन द्वारा पीले डंडे
orange time and date stamp##person,potted plant,chair,chair,potted plant,toothbrush,toothbrush	नारंगी समय और तारीख मोहर
Two female tennis players shaking hands##person,person,person,person,tennis racket,tennis racket,tennis racket	दो महिला टेनिस खिलाड़ी हाथ मिलाते हुए
A wooden stand##person,surfboard,chair	एक लकड़ी का स्टैंड
Four baseball players on field.##person,person,person,baseball bat,person,baseball glove,sports ball,baseball glove	मैदान पर चार बेसबॉल खिलाड़ी।
an American flag in the background of a press conference##person,person,person,tie,person,person,tie,person,cell phone,person	एक प्रेस कॉन्फ्रेंस की पृष्ठभूमि में एक अमेरिकी झंडा
two english spaniels standing near a person##dog,person,tie,dog	एक व्यक्ति के पास खड़े दो अंग्रेजी स्पैनियल्स
There is a book stand that is filled with books.##mouse,chair,cup,bottle,book,book,book,book,book,book	पुस्तकों से भरा एक पुस्तक स्टैंड है।
man taking pictures of players##person,person,person,person,tennis racket,person,person,person,person,person	खिलाड़ियों की तस्वीरें ले रहा आदमी
Black hat with a red cross##person,person,person,skis,skis,skis,person	काली टोपी के साथ एक लाल क्रॉस
three baseball players standing in a row##person,person,person,baseball glove,person,person,person,baseball bat,tennis racket	तीन बेसबॉल खिलाड़ी एक पंक्ति में खड़े हैं
A black and brown dog fast asleep on the couch.##dog,couch,couch,dog,cat	एक काला और भूरा कुत्ता सोफे पर गहरी नींद में सो गया।
the time stamp sitting in the corner##traffic light,person,train,train,person,traffic light,traffic light,traffic light,traffic light,fire hydrant	कोने में बैठे समय की मोहर
yellow plane with characters##airplane,airplane,truck,person,airplane,person,truck,truck,truck,bus	पात्रों के साथ पीला विमान
Buttons for pedestrians to cross the street##fire hydrant,car,person,car,car,traffic light,person,car,truck,person	सड़क पार करने के लिए पैदल यात्रियों के लिए बटन
A stand mixer##chair,microwave,dining table	एक स्टैंड मिक्सर
this players is shirtless##person,tennis racket,person,person,person,person,bottle,bottle,person,person	यह खिलाड़ी शर्टलेस है
pattern on side of second giraffe##giraffe,giraffe	दूसरी जिराफ की तरफ पैटर्न
a block on the ground##truck,bench,person	जमीन पर एक ब्लॉक
bicycles in stand##person,bicycle,bicycle,person,bicycle,bicycle,bicycle,bicycle,bicycle,bench	स्टैंड में साइकिल
a man photographs two baseball players##person,person,person,car,baseball bat,car,cell phone,car,handbag,truck	दो बेसबॉल खिलाड़ियों की तस्वीरें खींचता एक आदमी
a red don't cross signal.##traffic light,car,car,car,car,traffic light,car,car,car,traffic light	पार मत करो का एक लाल सिग्नल
French coffee press##person,refrigerator,cup,cup,dining table,cake,bowl,chair,sink,cell phone	फ्रेंच कॉफी प्रेस
black bicycle seat with supporting springs##cat,person,bicycle,bicycle,bicycle,bicycle,backpack,sheep	समर्थन स्प्रिंग्स के साथ काली साइकिल सीट
propeller is moving fast##airplane,person,person,airplane	प्रोपेलर तेजी से आगे बढ़ रहा है
toy models of buses##bus,bus,bus,bus,bus,bus,book,person,person,bus	बसों के खिलौना मॉडल
a motorcycle going fast##motorcycle,person	एक तेजी से जा रही मोटरसाइकिल
Shadow on the court##person,tennis racket,person,tennis racket,sports ball	कोर्ट पर छाया
A brick wall separating players and spectators.##person,person,person,baseball glove,baseball bat,person,person,person,chair,person	खिलाड़ियों और दर्शकों को अलग करने वाली एक ईंट की दीवार।
a fast moving hand##mouse,book,book,book,book,book,book,book,book,book	तेजी से बढ़ रहा हाथ
The night stand is wooden.##bed	नाइट स्टैंड लकड़ी का है।
baseball players posing together in an old photograph##person,person,person,person,person,person,person,person,person,person	बेसबॉल खिलाड़ी एक पुरानी तस्वीर में एक साथ पोज़ देते हुए
Net across tennis court##person,person,tennis racket,tennis racket,person,person,sports ball,sports ball,tennis racket,tennis racket	टेनिस कोर्ट के आर-पार नेट
glass top on night stand##bed,vase,clock,clock	नाइट स्टैंड पर ग्लास टॉप
raised cross on top of remote control##remote,person,book	रिमोट कंट्रोल के शीर्ष पर उच्चा क्रॉस
Grass growing on the grass tennis court.##person,tennis racket,sports ball	घास टेनिस कोर्ट पर बढ़ती जा रही है।
time stamp on the picture##person,teddy bear,teddy bear,book	तस्वीर पर समय की मुहर
two red metal springs##train	दो लाल धातु स्प्रिंग्स
a a block in a wall##person,skateboard,skateboard,potted plant	एक दीवार में एक ब्लॉक
People looking to cross the road.##car,car,car,person,traffic light,person,car,person,person,person	सड़क पार करते दिख रहे लोग।
the fair sky##horse,horse,horse	निष्पक्ष आकाश
a motorcycle is parked in front of the road block##motorcycle,motorcycle,car,person,car,person,car,car,motorcycle,car	रोड ब्लॉक के सामने एक मोटरसाइकिल खड़ी है
White striped pedestrian cross-walk painted on street.##person,person,person,person,person,person,person,traffic light,traffic light,kite	सड़क पर चित्रित सफेद धारीदार पैदल क्रॉस-वॉक।
Baseball team players in the dugout##person,person,person,baseball bat,baseball glove,person,person,person,frisbee,person	डगआउट में बेसबॉल टीम के खिलाड़ी
boy sitting cross legged##person,person,tie,person,person,person,tie,person,person,tie	क्रॉस लेग्ड बैठे हुआ लड़का
The man's hand forms a fist##person,surfboard,surfboard	आदमी का हाथ मुट्ठी बनाता है
stand of bamboo##person,person,cell phone,potted plant,potted plant	बाँस का स्टैंड
Statue honoring members of the armed forces##person,person,umbrella,person,person,person,umbrella,person,backpack,umbrella	सशस्त्र बलों के सदस्यों को सम्मानित करती हुई प्रतिमा
men of forces wearing the dress uniforms##motorcycle,person,person,person,person,person,person,person,person,person	वर्दी पहने बलों के पुरुष
Another stand and its owner##person,person,person,person,person,person,person,person,bench,person	एक और स्टैंड और उसके मालिक
A man stand next to a jeep.##person,person,person,skis,truck,suitcase,cell phone	एक आदमी एक जीप के पास खड़ा है।
The sign that says Alice springs##	ऐलिस स्प्रिंग्स कहने वाली संकेत
a sandwich on a block##sandwich,dining table,chair,bowl,knife	एक ब्लॉक पर एक सैंडविच
red bags behind players feet##person,person,person,person,person,baseball bat,bench	खिलाड़ियों के पैरों के पीछे लाल बैग
Asian characters on side of building##person,bus,person,bicycle,person,person,person,person,person,person	भवन के किनारे एशियाई अक्षर
The tennis player's shadow is on the tennis court.##person,tennis racket,sports ball,person,person,person,person,chair	टेनिस खिलाड़ी की परछाई टेनिस कोर्ट पर है।
fast looking yellow motorcycle##motorcycle,potted plant,motorcycle	तेज दिखने वाली पीली मोटरसाइकिल
white springs under bed##bed	बिस्तर के नीचे सफेद स्प्रिंग्स
a sponsors name on the tennis court wall##person,person,sports ball,chair,tennis racket	टेनिस कोर्ट की दीवार पर एक प्रायोजक का नाम
Asian characters written on a sign##bus,bus,car,bus,car,person,car,car,bus,bus	एक संकेत पर लिखे गए एशियाई पात्र
the date and time indicating the time of picture##train,train,handbag	दिनांक और समय चित्र का समय दर्शाता है
The light forms a rainbow##horse,horse,horse,cow,person	प्रकाश एक इंद्रधनुष बनाता है
Headpiece of the second rider from the right##horse,horse,horse,horse,person,horse,horse,person,person,person	दाईं ओर से दूसरे सवार का सिर
postage stamp with liberty bell##cat,book,book,bowl,book	डाक टिकट पर स्वतंत्रता की घंटी
Mud forms along the edge of the watering hole##giraffe,giraffe	पानी के छेद के किनारे मिट्टी के रूप में
an unfinished block of wood##scissors,bottle,knife,dining table,knife,remote,book	लकड़ी का एक अधूरा ब्लॉक
green grass behind players##person,person,person,baseball glove,baseball glove,skis	खिलाड़ियों के पीछे हरी घास
the second base coach watches the play##person,person,baseball glove,person,baseball glove,person,chair,person,person,person	दूसरा बेस कोच खेल देखता है
child's soft fine brown hair##teddy bear,person,bed,person,person	बच्चे के मुलायम महीन भूरे बाल
A black entertainment stand on wheels##tv,couch,chair,potted plant,potted plant,chair,chair,vase,potted plant,keyboard	पहियों पर एक काला मनोरंजन स्टैंड
fast motion image of woman walking in rain##person,umbrella	बारिश में चलने वाली महिला की तेज गति की छवि
second story of building holds two balconies##horse,horse,person,motorcycle,person,person,person,person,person,person	इमारत की दूसरी मंजिल में दो बालकनियाँ हैं
ovan kept in the stand##microwave,refrigerator,oven,knife,person,person,person,person,person,person	स्टैंड में रखा ओवान
The speaker on the stand##person,tv,chair,laptop,chair,person,tv,laptop	स्टैंड पर मौजूद स्पीकर
a man in front of a produce stand##person,person,banana,banana,person,apple,apple,person,banana,banana	एक उत्पाद स्टैंड के सामने एक आदमी
a fast moving train##train,train	एक तेज़ चलती ट्रेन
tennis players shadow on court##person,chair,chair,umbrella,chair,chair,chair,chair,chair,chair	कोर्ट पर टेनिस खिलाड़ी की छाया
date stamp on photo is 8/23/08##person,person,cell phone,book,dining table	फोटो पर तारीख मोहर 8/23/08 है
a man sitting on a cement block##person,dog,boat,boat,chair,boat,car,truck,chair,airplane	सीमेंट ब्लॉक पर बैठा एक आदमी
several baseball players in the dugout##person,person,person,person,person,person,bench,bench,person,baseball glove	डगआउट में कई बेसबॉल खिलाड़ी
An orange time stamp##zebra,car,car,car,car	एक नारंगी समय टिकट
the date is orange##zebra,zebra,zebra,sports ball,cow	खजूर नारंगी है
Grey block wall behind woman##person,cell phone,cell phone,cup	महिला के पीछे ग्रे ब्लॉक दीवार
english muffin with egg and hollandaise##broccoli,carrot,sandwich,dining table,cup,hot dog,donut,sandwich	अंडे और hollandaise के साथ अंग्रेजी मफिन
tail of elephant forms a circle##elephant,elephant,elephant,bird,bird	हाथी की पूंछ एक चक्र बनाती है
plant is on a metal stand##potted plant,couch,couch,laptop,vase,dining table	संयंत्र एक धातु स्टैंड पर है
stand for trays##person,book,book,oven,donut,oven,sink	ट्रे के लिए स्टैंड
this is a blue court##person,tennis racket,sports ball,bench,sports ball	यह एक नीली अदालत है
ginger with fair skin, orange hair, billions of freckles, and glasses##person,person,person,frisbee,frisbee,frisbee,person,chair,car	अदरक निष्पक्ष त्वचा, नारंगी बालों के साथ, अरबों झाई, और चश्मा
facial expression, particularly mouth that says, 'yeah, i'm fine w/ being a corporate drone##person,tie	चेहरे की अभिव्यक्ति विशेष रूप से मुंह, जो कहती है, 'हां, एक कॉर्पोरेट ड्रोन मैं ठीक हूं'
white block on the street##dog,fire hydrant,dog,car,motorcycle,person,car,bus,stop sign,car	सड़क पर सफेद ब्लॉक
boat forms ripples##boat,person	लहर बनाती नाव
child forces straws into a a can##person,cell phone,umbrella,cup,person	बच्चे एक कैन में जबरदस्ती स्ट्रॉ डालते हैं
Blue square on tennis court##person,tennis racket	टेनिस कोर्ट पर नीला स्क्वायर
the players tennis shoes are white##person,person,person,tennis racket,tennis racket,person,bottle,backpack,bench,sports ball	खिलाड़ी टेनिस जूते सफेद होते हैं
sign denoting 2900 block##person,truck,car,car,car,car,car,car,car,car	2900 ब्लॉक को दर्शाते हुए हस्ताक्षर करें
books in a black stand##person,person,refrigerator,dog,book,book,cat,book,book	एक काले स्टैंड में किताबें
date and time of picture##motorcycle,motorcycle,person,car,car,car,motorcycle,car,car,motorcycle	तस्वीर की तारीख और समय
a train stop block##train,person,person	एक ट्रेन स्टॉप ब्लॉक
Snow covered cross walk##car,car,car,car,car,car,car,car,car,car	बर्फ से ढका क्रॉस वॉक
the steeple has a cross on top##clock	स्टीपल के ऊपर एक क्रॉस है
Soccer players in action##person,person,person,person,person,sports ball	फुटबाल खिलाड़ी एक्शन में
tennis court in bounds area for doubles play##person,tennis racket,person,person,person,person,bird,person	युगल खेलने के लिए सीमा क्षेत्र में टेनिस कोर्ट
english word in green##airplane,person,truck	हरे रंग में अंग्रेजी शब्द
Brown tennis court with white lines.##person,person,sports ball,person,person,tennis racket,person,person,person,person	सफेद लाइनों के साथ ब्राउन टेनिस कोर्ट।
A brown stand next to a wall.##chair,chair,chair,chair,chair,potted plant,dining table,potted plant,chair,potted plant	एक दीवार के बगल में एक भूरा स्टैंड।
black iron gate with white cross##cow,cow,cow,truck,car,car,person,potted plant,person,person	सफेद क्रॉस के साथ काले लोहे का गेट
time stamp with red number##clock,potted plant	लाल नंबर के साथ समय टिकट
stack of books on bed stand##bed,potted plant,vase,book,book,book,bed,vase,book	बेड स्टैंड पर पुस्तकों का ढेर
knife set in a wooden block##bottle,bottle,bottle,bottle,bottle,bottle,bottle,bottle,bottle,bottle	लकड़ी के ब्लॉक में चाकू सेट
base ball diamond with players##person,person,person,person,person,person,person,person,person,person	खिलाड़ियों के साथ बेस बॉल डायमंड
Television in the tv stand.##person,potted plant,book,person,tv,book,person,book,vase,book	टीवी स्टैंड में टेलीविजन।
second green sign from the top##	ऊपर से दूसरा हरा चिन्ह
Date stamp 6/30/2013##train	दिनांक मोहर 6/30/2013
logo on the tennis court##person,tennis racket,sports ball	टेनिस कोर्ट पर लोगो
the necktie has a circle cross motif##person,tie,tie	नेकटाई में एक सर्कल क्रॉस मोटिफ है
a photographers stamp on the photo##airplane,airplane,airplane,airplane,airplane,airplane,airplane	फोटो पर एक फोटोग्राफर का मुहर
block of green water in front of surfer##person,surfboard	सर्फर के सामने हरे पानी का अवरोध
asian characters in red##person,person,person,person,car,person,truck,person,car,person	एशियाई वर्ण लाल में
A fine white sand##truck,person,person,person,person,person,dining table,person,person,umbrella	एक महीन सफेद रेत
night stand made of dark brown wood##bed,couch,bed	गहरे भूरे रंग की लकड़ी से बना नाइट स्टैंड
two players in ground##person,person,person,tennis racket	मैदान में दो खिलाड़ी
brown mane on neck of second giraffe##giraffe,person,giraffe	दूसरी जिराफ की गर्दन पर भूरे दाग
white engraved cross##teddy bear,teddy bear,person	सफेद उत्कीर्ण क्रॉस
Red and silver sign with Asian characters##traffic light,car,person,car,person,person,car,person,person,car	एशियाई अक्षर के साथ लाल और चांदी का चिह्न
Woman getting ready to cross street##car,person,car,car,person,car,handbag,car,car,car	सड़क पार करने के लिए तैयार हो रही महिला
press board table top##sandwich,sandwich,person,bowl,sandwich,chair,sandwich,person	प्रेस बोर्ड टेबल टॉप
the train is a fast speed train##train	ट्रेन एक तेज गति वाली ट्रेन है
People at a fair.##person,person,person,person,person,person,person,person,person,person	एक मेले में लोग।
a metal cross beam##giraffe,giraffe,giraffe,laptop,giraffe,chair	एक धातु पार बीम
players are playing baseball.##person,person,baseball glove,sports ball,tennis racket,person,sports ball	खिलाड़ी बेसबॉल खेल रहे हैं।
railed porch on the second floor of a home##person,backpack,skateboard	एक घर की दूसरी मंजिल पर स्थित बरामदा
Balconies on the second floor##person,book	दूसरी मंजिल पर बालकोनी
a plate with white characters##stop sign	सफेद पात्रों के साथ एक प्लेट
The players wear uniforms.##person,person,person,person,person,person,person,person,person,person	खिलाड़ी वर्दी पहनते हैं।
photographers watermark and date##sports ball,person,person,person,person,person,person	फोटोग्राफरों वॉटरमार्क और तारीख
Red table with fast food above it##person,dining table,chair,donut,chair,bus,dining table,chair,sandwich	साथ रेड टेबल के ऊपर फास्ट फूड
woman cross her arms##person,person,person,person,person,person,cake,person,dining table,person	महिला ने अपनी बाहों क्रॉस करते
The tracks cross here##train,train,person,person,bus,person,person,person	यहां पटरियां पार हो जाती हैं
"orange ""do not cross"" sign##car,fire hydrant,potted plant,traffic light,traffic light,traffic light,traffic light,person"	"नारंगी ""पार नहीं करते"" संकेत"
A person standing at the food stand.##chair,person,chair,chair,tv,chair,chair,chair,dining table,chair	भोजन स्टैंड पर खड़ा एक व्यक्ति।
Three players are wearing helmet.##person,person,person,baseball glove,person,baseball bat,person,person,person,person	तीन खिलाड़ी हेलमेट पहने हुए हैं।
a non english sign##car,car,car,car,car,car,truck,car,car,bus	एक गैर अंग्रेजी संकेत
player running on court##person,person,tennis racket,person,person,person,person,person,person,person	कोर्ट पर दौड़ता हुआ खिलाड़ी
the woman on the court##person,person,person,person,person,person,person,person,person,person	अदालत में महिला
A round concert block##toilet,spoon,spoon	एक गोल कंसर्ट ब्लॉक
fast food items on plates##dining table,hot dog,bowl,donut,bottle	प्लेटों पर फास्ट फूड आइटम
Top window pane in the left corner of the second story window##teddy bear,clock,person,teddy bear,handbag,donut	दूसरी मंजिल विंडो के बाएं कोने में शीर्ष विंडो फलक
boundary lines on court##person,person,person,person,person,person,tennis racket,person,person,person	न्यायालय पर सीमा रेखाएँ
second wooden vertical slat from left##bench	बाईं ओर से दूसरी लकड़ी की खड़ी स्लेट
A stand of trees along the edge of the lake##person,hot dog	झील के किनारे पेड़ों का एक स्टैंड
a blue and white cross walk sign##person,person,skateboard,skateboard,car,car,car	एक नीला और सफेद क्रॉस वॉक साइन
open door of a second bus##suitcase,person,suitcase,person,bus,suitcase,backpack,person,suitcase,person	एक दूसरी बस का खुला दरवाजा
floral box springs under mattress##person,bowl,bed,chair,donut	मैट्रेस के तहत पुष्प बॉक्स स्प्रिंग्स
street sign advising of penalty##car,person,traffic light,car,car,car,car,car,person,car	जुर्माने की सलाह देने वाली सड़क पर हस्ताक्षर
oranges and pears on the second layer of a fruit tree rack##banana,apple,apple,broccoli,orange,broccoli,orange,orange,dining table,broccoli	एक फल के पेड़ की रैक की दूसरी परत पर संतरे और नाशपाती
A skier going down fast on a slope##person,skis,skis	ढलान पर तेजी से नीचे जा रहा एक स्कीयर
an english saddle above a saddle pad##horse,person,horse,person,horse,person,stop sign,horse,tie	एक काठी पैड के ऊपर एक अंग्रेजी काठ
four shadowy forms of giraffes seemingly looking forward##giraffe,giraffe,giraffe,giraffe	जिराफ के चार छायादार रूप प्रतीत होते हैं
dirty concrete wall behind players##person,person,car,sports ball,cup,baseball bat	खिलाड़ियों के पीछे गंदी कंक्रीट की दीवार
a couple of elephants photoshopped to stand out##elephant,elephant,elephant,elephant,elephant,elephant,elephant,elephant,elephant	हाथियों के एक जोड़े को फ़ोटोशॉप किया गया
The fast moving subway train##train,person,person,bottle,carrot,bottle,train	तेज गति से चलने वाली मेट्रो ट्रेन
the net between the two players##person,person,tennis racket,tennis racket	दोनों खिलाड़ियों के बीच नेट
Baseball glove on players left hand##person,person,baseball glove,sports ball,baseball glove	खिलाड़ियों के बाएं हाथ पर बेसबॉल दस्ताने
silver and black french coffee press on shelf##dog,potted plant,potted plant,potted plant,potted plant,bottle,cup,potted plant	चांदी और काले फ्रेंच कॉफी शेल्फ पर प्रेस
grey block in sidewalk##car,car,car,car,car,car,car,car,car,person	फुटपाथ में ग्रे ब्लॉक
short tan entertainment stand##chair,chair,couch,tv,potted plant,bottle,tv,vase,book,vase	लघु टैन मनोरंजन स्टैंड
A wooden block holding up the boat##boat	नाव को पकड़े हुए एक लकड़ी का ब्लॉक
fence next to players##person,person,baseball bat,sports ball,baseball bat,sports ball	खिलाड़ियों के बगल में बाड़
Oranges on a fruit stand##orange,orange,orange,orange,orange,orange,orange,orange,orange,orange	एक फल स्टैंड पर संतरे
a butcher block with knives##oven,vase,traffic light	चाकू के साथ एक कसाई ब्लॉक
Cluttered night stand##bed,book,vase,book,book,book,book,book	बरबाद नाइट स्टैंड
tan house with lighter colored second floor##car,car,car,fire hydrant,car,car,car	हल्के रंग की दूसरी मंजिल के साथ तन घर
two white chairs on tennis court##person,chair,chair,tennis racket,chair,person,person,sports ball,person,person	टेनिस कोर्ट पर दो सफेद कुर्सियाँ
a cross railway sign##stop sign,train,train	एक क्रॉस रेलवे साइन
a triangle forms on brick##toilet,toilet	ईंट पर एक त्रिकोण रूप
A fast boat with people in it##boat,person	लोगों के साथ एक तेज नाव
People waiting to cross street.##bus,traffic light,person,person,person,person,person,person,person,person	सड़क पार करने का इंतजार करते लोग।
the button to press for the light is below the signal##person,car,skateboard,traffic light,person	प्रकाश के लिए संकेत के नीचे बटन को दबाएं
dirt ground elephants stand on##elephant,elephant	हाथी गंदगी के मैदान पर खड़े हैं
the springs on the motorcycle##motorcycle,person,person,person,motorcycle,person,person,frisbee,person,traffic light	मोटरसाइकिल पर स्प्रिंग्स
marked pedestrian cross walk##stop sign,fire hydrant,car	चिह्नित पैदल यात्री क्रॉस वॉक
The water is flowing fast##person,boat,person,person,surfboard,surfboard	पानी तेजी से बह रहा है
The word AUG in the date##remote,person,remote,person,book,couch,bed,person,person,person	तिथि में AUG शब्द
wooden slat that forms back of bench.##bench,car	बेंच की पीठ लकड़ी की स्लेट से बनती है।
the two male players are after the ball##person,person,person,sports ball,person,person,person,person,motorcycle,person	दो पुरुष खिलाड़ी गेंद के पीछे हैं
power lines cross in the air##traffic light,person	बिजली लाइनों हवा में आर-पार
area next to pot stand##vase	पॉट स्टैंड के बगल का क्षेत्र
fast food in the backgrond##bench,person,person,person,person,person,person,person,person,handbag	बैकग्रोनड में फास्ट फूड
this is a concrete yellow block##umbrella,umbrella,umbrella,person,umbrella,person,umbrella,umbrella,umbrella,umbrella	यह एक ठोस पीला ब्लॉक है
shadow on tennis court.##person,tennis racket,sports ball	टेनिस कोर्ट पर छाया।
tennis court marked with white color##person,tennis racket,person,car,car,bench	टेनिस कोर्ट सफेद रंग से चिह्नित
a green Christmas tree stand##person,tie,book,book,book,book,book,book,book,book	एक हरे रंग का क्रिसमस ट्री स्टैंड
a business man waiting to cross the street##person,person,person,car,truck,handbag,traffic light,person,person,person	एक व्यवसायी व्यक्ति सड़क पार करने की प्रतीक्षा कर रहा है
A white stand mixer##person,person,oven,oven,bowl,cup,cup,cup,bowl,book	एक सफेद स्टैंड मिक्सर
The time stamp is red.##stop sign,car,car,truck	समय की मोहर लाल है।
cross section of a broccoli stem##broccoli,broccoli,broccoli,broccoli,broccoli,broccoli,broccoli,broccoli,broccoli,broccoli	ब्रोकोली स्टेम के पार अनुभाग
players in the dugout.##person,baseball bat,person,person,person,person,person,person,person,person	डगआउट में खिलाड़ी।
a green fence at a tennis court##person,person,person,person,person,umbrella,person,person,person,person	एक टेनिस कोर्ट में एक हरे रंग की बाड़
person playing tennis on the court##person,tennis racket,person,chair,person,chair	कोर्ट में टेनिस खेलने वाला व्यक्ति
Man trying to block the throwing of a frisbee##person,person,person,frisbee,sports ball,chair,sports ball,chair,chair,chair	आदमी एक फ्रिसबी फेंकने को अवरुद्ध करने की कोशिश कर रहा है
the balcony on the second floor##truck,bus,bus,truck,truck	दूसरी मंजिल पर बालकनी है
Red dragon fruit on a fruit stand.##person,banana,banana,banana,banana,banana,banana,banana,banana,banana	फल स्टैंड पर लाल ड्रैगन फल।
person setting in second seat of bus##person,bus,person,person,person,person,car,handbag,person,handbag	बस की दूसरी सीट पर बैठे व्यक्ति
The body of the stand up lamp.##chair,chair,tv,dining table,couch,dining table,dining table,chair,chair	स्टैंड अप लैंप का शरीर।
The players are male.##person,person,baseball glove,sports ball	खिलाड़ी पुरुष हैं।
A fence at a tennis court##person,person,person,sports ball,backpack,chair,backpack	एक टेनिस कोर्ट में एक बाड़
the date says 7-1##refrigerator,person,refrigerator,person,refrigerator,person,person,person,person,person	दिनांक 7-1 कहता है
picture hanging in the wall with anime characters##mouse,keyboard,mouse,tv,cup,tv,laptop,bottle,person,person	एनीमे पात्रों के साथ दीवार में लटका चित्र
a grill press##person,hot dog,hot dog,hot dog,hot dog,hot dog,hot dog,hot dog,hot dog,hot dog	एक ग्रिल प्रेस
Bird models suspended in shopping mall.##bird,person,person,person,person,bird,person,person,person,person	शॉपिंग मॉल में बर्ड मॉडल निलंबित।
green wall on tennis court##person,sports ball,person,person,person,chair,person,person,person,person	टेनिस कोर्ट पर हरी दीवार
Woman in an english style saddle##person,horse,person,person,person,person,person,person,person,bottle	एक अंग्रेजी शैली की काठी में महिला
Photo date stamp##person,chair,chair,chair,couch,clock,chair,potted plant,clock,clock	फोटो तारीख की मोहर
the copyright and date stamp of the photographer##teddy bear,teddy bear,person,potted plant,potted plant,chair,chair,cup,book,dining table	फोटोग्राफर का कॉपीराइट और तारीख मोहर
a man stand on dock##boat,person,person,person,boat	एक आदमी डॉक पर खड़ा है
two players wearing white shorts##person,person,person,person,tennis racket,person,chair,person,person,person	सफेद शॉर्ट्स पहने हुए दो खिलाड़ी
People on the court playing tennis.##person,person,tennis racket,bench,tennis racket	कोर्ट पर लोग टेनिस खेल रहे हैं।
A blue fine on the surf board.##person,person,person,truck,surfboard,person,truck	सर्फ बोर्ड पर एक नीला जुर्माना।
White potted flowers on the tennis court##person,potted plant,tennis racket,potted plant	टेनिस कोर्ट पर सफेद फूल खिले
a toasted english muffin##fork,cup,knife,carrot,dining table,cake,carrot,cake,knife,cup	एक टोस्ट अंग्रेजी मफिन
Baseball player stealing second base##person,person,person,baseball glove,bed,person	बेसबॉल खिलाड़ी ने दूसरा बेस चुरा लिया
a date stamp for 2010/02/07##cow,cow,boat,cow,cow	2010/02/07 के लिए एक तारीख मोहर
second story of house##person,baseball bat,sports ball	घर की दूसरी मंजिल
Blue cross window on second floor##bus,person,person	दूसरी मंजिल पर ब्लू क्रॉस विंडो
bird characters on top of a brown cake##cake,bird,bird,bird,bird	एक भूरे रंग के केक के ऊपर पक्षी के पात्र
a advertisement for highland springs##person,person,tennis racket,tennis racket,person,person,person,person,person,person	हाइलैंड स्प्रिंग्स के लिए एक विज्ञापन
the tennis court is made of grass##person,person,person,tennis racket,person,person,person,person,person,person	टेनिस कोर्ट घास से बना है
a line of runway models##person,person,person,person,person,person,person,person,person,person	रनवे मॉडल की एक पंक्ति
yellow numbers showing the date##sink,sink,toothbrush,kite	पीले रंग की संख्या दिनांक दिखा रही है
A women skiing fast.##person,skis	एक महिला स्कीइंग तेजी से।
cross country ski racers skiing up a hill.##person,person,person,person,person,person,person,person,person,person	क्रॉस कंट्री स्की रेसर एक पहाड़ी पर स्कीइंग करते हैं।
Three women soccer players sitting on a bench.##person,person,sports ball,person,person,person,person,backpack,person,backpack	एक बेंच पर बैठी तीन महिला फुटबॉल खिलाड़ी।
decaying amazing building that looks like something between an aztec and buddhist shrine in the english countryside##cow,cow	अंग्रेजी देश में एज़्टेक और दोस्त तीर्थ के बीच कुछ की तरह लगने वाली अद्भुत इमारत का क्षय
A pot is fitted in a stand.##bowl,microwave,bowl,spoon,book,oven,cup,book,toothbrush,book	एक बर्तन को एक स्टैंड में फिट किया जाता है।
Safety railing on second story of building##person,person,umbrella,motorcycle,person,person,car,person,person,umbrella	इमारत की दूसरी कहानी पर सुरक्षा रेलिंग
Man sits floor cross legged##suitcase,dog,person,person,person,suitcase,suitcase,baseball bat,person,suitcase	मैन फ्लोर क्रॉस लेग साइड बैठता है
White writing on a blue court.##person,person,tennis racket,person,person,person,person,bench,person,person	नीली अदालत पर सफेद लेखन।
a very fast baseball##person,person,person,person,baseball glove,person,person,person,person,person	एक बहुत तेज बेसबॉल
White clock face with brown characters##clock,stop sign,spoon,traffic light	भूरे रंग के पात्रों के साथ सफेद घड़ी चेहरा
buildings are behind the road block##truck,person,car,handbag,car,truck,car	सड़क ब्लॉक के पीछे इमारतें हैं
Young woman in grey sweatshirt hoping to block frisbee.##person,person,frisbee,person,person,person,person,person,person,car	ग्रे स्वेटशर्ट में युवा महिला फ्रिसबी को ब्लॉक करने की उम्मीद करती है।
people on the second floor##person,person,person,person,person,person,person,person,person,person	दूसरी मंजिल पर लोग
a red dirt tennis court##person,sports ball,tennis racket	एक लाल गंदगी टेनिस कोर्ट
Black block with number on it##person	उस पर नंबर के साथ ब्लैक ब्लॉक
stuffed disney characters##person,cup,bed,teddy bear,teddy bear,person	भरवां डिज्नी पात्रों
players waiting in dugout##person,person,person,person,person,baseball glove,person,person,person,baseball bat	डगआउट में इंतजार कर रहे खिलाड़ी
baseball players white pants##person,person,baseball bat,baseball glove,baseball glove	बेसबॉल खिलाड़ी सफेद पैंट
A motorcycle kick stand.##motorcycle,potted plant,person,person,motorcycle,motorcycle,motorcycle	एक मोटरसाइकिल किक स्टैंड।
There is some fine sand here##umbrella,person,person,bench	यहाँ कुछ ठीक रेत है
a metal orange juice press##chair,cup,orange,chair,chair,orange,apple,orange,carrot,donut	एक धातु संतरे का रस प्रेस
a baseball players uniform##person,baseball glove,sports ball,person,person,person,person,person,person,person	एक बेसबॉल खिलाड़ियों की वर्दी
Three baseball players on baseball field.##person,person,person,person,baseball bat,person,baseball glove,baseball glove,baseball glove,person	बेसबॉल मैदान पर तीन बेसबॉल खिलाड़ी।
Booths at a street fair.##person,person,person,vase,handbag,umbrella,sandwich,dining table,sandwich,person	एक सड़क मेले में बूथ।
Back right foot of the second goat##sheep,sheep,couch	दूसरे बकरे का पिछला दाहिना पैर
fine toothed blade of knife##scissors,knife,scissors,scissors,person,knife,knife,knife,cell phone	चाकू के ठीक दांतेदार ब्लेड
guy's hand trying to block the camera##laptop,person	कैमरे को अवरुद्ध करने की कोशिश कर रहा आदमी का हाथ
Baseball in players right hand##person,person,baseball glove,baseball glove,person,person,sports ball	खिलाड़ियों के दाएं हाथ में बेसबॉल
The second highest rail of the jump##person,horse,umbrella,umbrella	छलांग का दूसरा सबसे बड़ा रेल
a white paper not in english##person,motorcycle,motorcycle,motorcycle,motorcycle,person,motorcycle,motorcycle,car,person	एक सफेद कागज अंग्रेजी में नहीं
green and white concession stand near umbrella##person,person,person,frisbee,person,person,person,person,person,umbrella	हरे और सफेद रियायत छाता के पास खड़े हैं
metal stand for ropes##bowl,bowl,dining table,bowl,sink,dining table,book,bowl,bowl,chair	रस्सियों के लिए धातु स्टैंड
an umbrella standing in a tennis court##person,person,person,chair,chair,person,umbrella,tennis racket,backpack,umbrella	एक टेनिस कोर्ट में एक छाता खड़ा है
there are english and Chinese characters##traffic light	अंग्रेजी और चीनी अक्षर हैं
a bench along a tennis court##person,person,person,person,sports ball,kite,bottle,bottle	एक टेनिस कोर्ट के साथ एक बेंच
a young girl with a fair complexion##person,person,person,teddy bear,person,person,backpack,backpack,person,person	एक युवा लड़की एक निष्पक्ष संगति के साथ
The players uniform is white##person,person,person,person,person,person,chair,baseball bat,chair,chair	खिलाड़ियों की वर्दी सफेद है
a motorcycle side stand##motorcycle,potted plant	एक मोटर साइकिल साइड स्टैंड
The second clock showing on the tower.##clock,clock	टावर पर दिखने वाली दूसरी घड़ी।
tennis court floor##person,person,person,tennis racket,person,person,person,person,person,person	टेनिस कोर्ट का फर्श
cross on top of steeple##horse,horse,horse,horse,person,traffic light,person,person,clock,person	सीढ़ियों के ऊपर से पार
the players are on a field##frisbee,person,person,person,person,car,sports ball,sports ball,car	खिलाड़ी एक मैदान पर हैं
the second car in the train##train,person	ट्रेन में दूसरी कार
A TV stand sitting under TV##tv,person,chair,tv,person,chair,chair,chair,person	टीवी के नीचे एक टीवी स्टैंड
two young softball players sitting on the bench##person,person,baseball glove,bench	बेंच पर बैठे दो युवा सॉफ्टबॉल खिलाड़ी
man on a tennis court on a sunny day##person,tennis racket	एक धूप दिन पर टेनिस कोर्ट में आदमी
mass sheep and woolcraft fair ribbon##carrot,carrot,sheep,sheep,sheep,sheep,sheep,teddy bear,sheep,bird	बड़े पैमाने पर भेड़ और ऊन का मेला रिबन
the combs are fine##bench	कंघी ठीक हैं
cap on players head##person,baseball glove,sports ball	खिलाड़ियों के सिर पर टोपी
the models are red and black##car,car,chair,truck	मॉडल लाल और काले हैं
Green and red tennis court##person,sports ball,person,person,person,person,person,person,person,person	ग्रीन और रेड टेनिस कोर्ट
a celtic cross stone monument##sheep,sheep,sheep,sports ball,sheep,parking meter,sheep,sheep	एक केल्टिक क्रॉस स्टोन स्मारक
plants behind toy models##train	खिलौना मॉडल के पीछे पौधे
wave is moving fast##person,surfboard	लहर तेज चल रही है
red double decker bus with Chinese characters and number 8##bus,car,person,traffic light,car,person,traffic light,person,person,person	लाल डबल डेकर बस woth चीनी अक्षर और नंबर 8
this shop sells fine ales##fire hydrant,book,book	यह दुकान बढ़िया एल्स बेचती है
orange street block##skateboard,person,person,person	नारंगी सड़क ब्लॉक
cross section of fans at baseball game##person,baseball glove,person,person,person,person,person,person,person,person	बेसबॉल खेल में प्रशंसकों का क्रॉस सेक्शन
large soft drink cup from a fast food restaurant or store##remote,laptop,cup,chair,person,keyboard,dining table,remote,keyboard	फास्ट फूड रेस्तरां या स्टोर से बड़े शीतल पेय कप
red bananas at a fruit stand##banana,banana,banana,apple,banana,apple,apple,apple,apple,apple	एक फल स्टैंड पर लाल केले
train moving fast blurring image##backpack,person,person,person,bicycle,person,person,person,bus,backpack	ट्रेन तेजी से धुंधला छवि चलती है
this sign is not in english##bicycle,person,car,person,person,bus,person,person,truck,person	यह संकेत अंग्रेजी में नहीं है
an apple cider press##person,person,person,apple,bottle,apple,apple,apple,apple,apple	एक सेब साइडर प्रेस
Black tv on top of brown stand.##tv,vase,vase,couch,potted plant,potted plant,vase,book,couch,potted plant	ब्राउन स्टैंड के शीर्ष पर ब्लैक टीवी।
a hand moving too fast for the camera##laptop,person,person,person,potted plant,cell phone,person,person,hot dog,hot dog	एक हाथ कैमरे के लिए बहुत तेजी से आगे बढ़ रहा है
Starps on the stand.##chair,tv,couch,couch,chair,chair,remote,chair,dining table,vase	स्टैंड पर तारे।
medium brown wood fine grained table##fork,dining table,laptop,dining table,spoon	मध्यम भूरे रंग की लकड़ी ठीक दानेदार मेज
Back of court is green.##person,person,tennis racket,person,tennis racket	कोर्ट ऑफ बैक हरा है।
white trail that can only be made by incredibly fast planes##airplane	सफेद निशान जो केवल अविश्वसनीय रूप से तेज विमानों द्वारा बनाया जा सकता है
score card being held by a man on tennis court##person,person,person,tennis racket,sports ball	टेनिस कोर्ट पर एक आदमी द्वारा आयोजित किया जा रहा स्कोर कार्ड
Man seated at food court table##person,chair,person,person,chair,person,person,person,person,person	मैन फूड कोर्ट टेबल पर बैठा
black cap on players head##person,person,person,person,person,person,person,person,person,chair	खिलाड़ियों के सिर पर काली टोपी
sydney written in white letters on court##person	अदालत में श्वेत पत्र में लिखा गया sydney
fine whiskers on animal's chin##cow,bench	जानवरों की ठोड़ी पर ठीक मूंछ
a green chair on a tennis court##person,tennis racket,chair,chair,chair	टेनिस कोर्ट पर हरी कुर्सी
Dollar amount of the penalty.##traffic light	जुर्माना की डॉलर राशि।
Baseball catcher watching players##person,person,person,person,person,person,person,person,person,chair	खिलाड़ियों को देखते हुए बेसबॉल पकड़ने वाला
white Arabic characters on sign##stop sign,person,suitcase	सफेद अरबी अक्षर
poster with cartoon characters##person,laptop,mouse,person,bottle,chair,bird,chair,keyboard,mouse	कार्टून पात्रों के साथ पोस्टर
A time date stamp in the corner##truck,traffic light,train,truck	कोने में एक समय की तारीख मोहर
window planters outside second story##bus,person,person,person,person,bicycle,bicycle,bicycle,bicycle,person	दूसरी कहानी के बाहर खिड़की बागान
green floor next to court##person,person,person,person,person,tennis racket,person,person,person,person	अदालत के आगे हरी मंजिल
The boy has a orange stamp on his hand.##person,zebra,car,toilet	लड़के के हाथ पर नारंगी मोहर है।
black mit in players hand##person,person,person,person,person,handbag,person,baseball glove,person,person	खिलाड़ियों के हाथ में काली घटा
cross next to the clock tower##clock,car	क्लॉक टॉवर के बगल में स्थित है
sheep running really fast##sheep,sheep,sheep	भेड़ें बहुत तेज दौड़ रही हैं
advertising to the state fair is mounted on the lamp post##	राजकीय मेले का विज्ञापन लैंप पोस्ट पर लगाया जाता है
bed pillow with cartoon characters on it##bed,person,person,person,book,person,book	उस पर कार्टून पात्रों के साथ बिस्तर तकिया
tennis court being used in a match##person,person,person,person,chair,person,person,chair,person,chair	एक मैच में टेनिस कोर्ट का इस्तेमाल किया जा रहा है
Knives in wood block##toaster,chair,chair,chair,bottle,knife,dining table,knife,knife,oven	लकड़ी के ब्लॉक में चाकू
part of the ball field with players getting ready to play##person,person,baseball glove,person,person,person,person,person,person,person	खिलाड़ियों के खेलने के लिए तैयार होने के साथ गेंद मैदान का हिस्सा
the weather is fair##person,skis,skis,backpack,backpack,backpack,backpack,backpack	मौसम निष्पक्ष है
cement block siding on church##clock,person,person,clock,handbag,backpack,traffic light	चर्च पर सीमेंट ब्लॉक साइडिंग
a man in the armed forces##person,person,frisbee,backpack,truck,truck,car,car,car	सशस्त्र बलों में एक आदमी
The car is moving fast.##train,car	कार तेजी से आगे बढ़ रही है।
block wall behind giraffe head##giraffe,giraffe,giraffe	जिराफ सिर के पीछे की दीवार
yellow stand##bus,car,person,person,car,car,person,person,handbag,car	पीला स्टैंड
chinese characters are in the sign##	चीनी अक्षर संकेत में हैं
the seat of the second motorcycle##motorcycle,motorcycle	दूसरी मोटरसाइकिल की सीट
Green part of a tennis court.##person,tennis racket	एक टेनिस कोर्ट का हरा हिस्सा।
the wave moves fast##person,surfboard	लहर तेज चलती है
White second hand on the clock.##clock,person	घड़ी पर सफेद दूसरा हाथ।
green colored material separating the court##person,person,person,person,person,person,person,person,tennis racket,person	हरे रंग की सामग्री अदालत को अलग करती है
The traffic lights stand out a lot.##person,traffic light,car,car,traffic light,person,traffic light,car,person,car	ट्रैफिक लाइट बहुत बाहर खड़ी है।
fine stitching on leash##dog	पट्टा पर ठीक सिलाई
Kick stand on a motorcycle.##motorcycle,person,traffic light,traffic light,car,car,car,person,motorcycle,fire hydrant	एक मोटरसाइकिल पर किक स्टैंड।
An electronic display showing the date##clock,tv	एक इलेक्ट्रॉनिक डिस्प्ले जिसमें तारीख दिखाई गई है
cement block facade on a building##person,person,cell phone	एक इमारत पर सीमेंट ब्लॉक मुखौटा
person forces cow to ramble over rocks for unknown reason##cow,person,baseball bat	व्यक्ति अज्ञात कारणों से गाय को चट्टानों पर फेंकने के लिए मजबूर करता है
a cross walk across street white pattern##fire hydrant,car,car,car,car,car,car,car,car,car	सड़क के पार सफेद पैटर्न पर एक क्रॉस वॉक
two lemons together on a block##orange,orange,potted plant,oven,dining table,oven,cup,broccoli	एक ब्लॉक पर एक साथ दो नींबू
white teeth-like forms on top of wing##airplane,car	सफेद दांत जैसे पंख के ऊपर के रूप
date in red letters and numerals##umbrella,clock,potted plant,clock,umbrella,potted plant,potted plant,potted plant,clock	लाल अक्षरों और अंकों में तारीख
empire near second base##person,person,baseball bat,person,baseball glove,tie,tie	दूसरे बेस के पास साम्राज्य
second place is wearing yellow##person,sheep,sheep,umbrella,sheep,dog,teddy bear,person,dog,person	दूसरा स्थान पीला पहने हुए है
man in the middle of tennis court##person	टेनिस कोर्ट के बीच में आदमी
The second sign says 4 way.##stop sign,stop sign	दूसरा संकेत 4 तरह से कहता है।
five wheels on the court##person,person,bicycle,person,bicycle,person,chair,person,person,remote	कोर्ट पर पांच पहिए
Red T-shirt with white cross patch##person,tennis racket,sports ball,person,person,person,person,person,person,person	सफेद क्रॉस पैच के साथ लाल टी-शर्ट
small white rocking chair with mother and child models in it##person,person,person,person,person,person,person,person,boat,person	इसमें मां और बच्चे के मॉडल के साथ छोटी सफेद रॉकिंग कुर्सी
The comb is fine toothed.##person,person,person	कंघी ठीक दांतेदार है।
date stamp on the photo##person,person,airplane,person,person,person,person,person,person,person	फोटो पर तारीख की मोहर
Chinese characters on the sign##person,person,remote,chair,laptop,chair,chair,laptop	चिन्ह पर चीनी अक्षर
The sky is fair.##bicycle,bench,bench,bottle,boat,bicycle,boat,boat,boat,bottle	आसमान साफ ​​है।
a green court##person,tennis racket,sports ball	एक हरी कोर्ट
a woman walking throw a trade fair##person,toilet,person,sink,refrigerator,laptop,cup,person,person	व्यापार मेला से गुजरती एक महिला
A crowd of people standing at the fair.##person,person,kite,person,kite,kite,umbrella,person,person,person	मेले में खड़े लोगों की भीड़।
a man standing on court##person,person,person,sports ball,bicycle	एक आदमी अदालत में खड़ा है
cross on a building##bird,bird,bird,bird,bird,bird	एक इमारत पर क्रॉस
the players shoes have spikes##person,person,person,person,baseball bat,person,person,person,person,person	खिलाड़ियों के जूते में स्पाइक्स होते हैं
A large brown block.##person,car,person,person,skateboard,dog,car,person,person,car	एक बड़ा भूरा ब्लॉक।
Man skiing fast##person,person,person,person,person,skis,person,person,person,skis	आदमी स्कीइंग तेजी से
the person has fair skin##remote,keyboard,keyboard,person,keyboard	व्यक्ति की त्वचा निष्पक्ष होती है
Skid foot marks on a tennis court##person,tennis racket,sports ball	टेनिस कोर्ट पर स्किड फुट के निशान
a woman in a fair isle sweater##person,bottle,bottle,cake,oven,bottle,bottle,cake,bottle,bottle	फेयर आइल स्वेटर में एक महिला
Shadow on the ground of the second racket from the left##person,person,sports ball,person,tennis racket,person,person,person,person,person	बाईं ओर से दूसरे रैकेट की जमीन पर छाया
A backwards baseball hat on the players head.##person,tennis racket,sports ball	खिलाड़ियों के सिर पर पीछे की तरफ वाली बेसबॉल टोपी।
a watermark and date##person,surfboard	एक वॉटरमार्क और दिनांक
the toys are on the stand##tv,couch,suitcase,tv,dining table,vase	खिलौने स्टैंड पर हैं
a second statue of a cow##cow,cow	एक गाय की दूसरी मूर्ति
large crack in tennis court##person,person,tennis racket,tennis racket,car	टेनिस कोर्ट में बड़ी दरार
The white ice models in the room.##bear	कमरे में सफेद बर्फ के मॉडल।
hairy arm with fair pale skin##person,refrigerator,truck,truck	निष्पक्ष हाथ की त्वचा के साथ बालों वाली बांह
Paper on night stand##bed,chair,couch,cup	नाइट स्टैंड पर कागज
date stamp that reads 12/04/2010##truck,truck,person,truck,truck,truck,person	दिनांक स्टैम्प जो 12/04/2010 को पढ़ता है
Yellow criss cross on the street by train.##train,traffic light,train,person,train,car,car,traffic light	ट्रेन से सड़क पर उतरता पीला क्रास।
base ball opponent players##person,person,person,baseball bat,person,person,person,baseball glove,person,person	बेस बॉल विरोधी खिलाड़ी
three baseball players playing a game##person,person,person,person,baseball glove,person,person,baseball bat,person,person	खेल खेलने वाले तीन बेसबॉल खिलाड़ी
The white bins on the second shelf of the fridge.##chair,refrigerator,bowl,bottle,microwave,bottle	फ्रिज के दूसरे शेल्फ पर सफेद डिब्बे।
fine texture of feathers##bird	पंख की ठीक बनावट
large orange and green sign giving name and date##motorcycle,person,motorcycle,person,motorcycle,truck,car,car,motorcycle,motorcycle	बड़े नारंगी और हरे रंग का नाम और तारीख देते हुए
green cross on top of building##	इमारत के शीर्ष पर हरे रंग की क्रॉस
colorful bus parked next to a stand and umbrella##bus,person,umbrella,person,umbrella,person,person,person,person	रंगीन बस स्टैंड और छतरी के बगल में खड़ी है
a purple umbrella with little cartoon characters##umbrella,person,person	बैंगनी कार्टून जिसमें छोटे कार्टून चरित्र हैं
the date is shown on the outter portion##clock	तारीख को बाहरी भाग पर दिखाया गया है
fast moving ball towards home plate##person,person,sports ball,baseball glove	तेजी से चलती गेंद घर की प्लेट की ओर
a fast food ordering bar##person,person,person,person,person,person,person,person,handbag,person	एक फास्ट फूड ऑर्डरिंग बार
The date 02/10/2009.##knife,person,carrot,carrot,knife,carrot,dining table	दिनांक 02/10/2009।
train going by fast##person,train,bench,person	ट्रेन तेजी से जा रही है
date and time stamp##keyboard,dining table	तारीख और समय टिकट
person has fair colored skin##horse,person,dog	व्यक्ति की त्वचा का रंग गोरा होता है
the copyright stamp on the photo##person,sports ball,tennis racket,tennis racket	फोटो पर कॉपीराइट की मुहर
grey fine toothed comb##scissors,toothbrush,scissors,scissors	ग्रे ठीक दांतेदार कंघी
pizza on a butcher block table##cup,pizza,pizza,broccoli	कसाई ब्लॉक की मेज पर पिज्जा
gold Chinese characters on a red flag##traffic light,tv	लाल झंडे पर सोने के चीनी पात्र
The date stamp on the photo.##	फोटो पर तारीख की मोहर।
red and white cross on man's shoulder##person,cow,baseball glove,cow	आदमी के कंधे पर लाल और सफेद क्रॉस
second bird is standing on car##bird,bird,person,person,car,car	दूसरा पक्षी कार पर खड़ा है
white lines painted on court##person,person,person,person,clock,person,person,person,person,tennis racket	कोर्ट पर चित्रित सफेद लाइनें
A tennis court has snow on the surface##person	एक टेनिस कोर्ट में सतह पर बर्फ है
a metal stand under the seat of a bench##refrigerator,bench,suitcase,chair	एक बेंच की सीट के नीचे एक धातु स्टैंड
a railing forms a corner sitting area##suitcase,chair,clock,bed,person	एक रेलिंग एक कोने के बैठने का क्षेत्र बनाती है
boy sitting cross-legged on ground##person,person,person,person,person,person,baseball bat,baseball bat,person,person	लड़का जमीन पर क्रॉस-लेग किया हुआ बैठा था
date and hotel that the photo was taken##teddy bear,cake,person,person,person,dining table	तारीख और होटल कि तस्वीर ली गई थी
fine china with flower design##person,wine glass,person,spoon,spoon,knife,dining table,chair,chair,spoon	फूल डिजाइन के साथ ठीक चीन
green field next to players##person,person,person,baseball glove	खिलाड़ियों के आगे हरा मैदान
black metal cross-walk light##traffic light,car,traffic light,traffic light	ब्लैक मेटल क्रॉस-वॉक लाइट
a lone spectator behind the tennis players##person,person,person,person,person,person,person,person,person,person	टेनिस खिलाड़ियों के पीछे एक अकेला दर्शक
the picture has a date stamp##keyboard,tv,book,book	तस्वीर में एक तारीख मोहर है
Calendar has star wars characters on it##keyboard,chair,tv,mouse,tv,cup,book,book,book,book	कैलेंडर में इस पर स्टार वार्स कैरेक्टर हैं
spectator seats at a tennis court##person,tennis racket	टेनिस कोर्ट में दर्शक सीटें
a hard true tennis court##person,sports ball,tennis racket	एक सच्चा टेनिस कोर्ट
Grate over a concrete block##banana,person,banana,banana	एक कंक्रीट ब्लॉक पर पीसें
foreign characters on the vehicle's side##train,bus,person,bird	वाहन की तरफ विदेशी अक्षर
wood platform for bird to stand on##bird,person,clock	पक्षी के लिए लकड़ी का मंच
Woman going fast downhill.##person,skis	तेज गति से जा रही महिला।
second floor windows##bus,person,person,car,person,person,person,person,person,person	दूसरी मंजिल की खिड़कियां
second red and blue train##train,train,train,train,train,train,person,car,train,car	दूसरी लाल और नीली ट्रेन
White lamp shade on tall stand##tv,cat,couch,couch,bowl	लंबे स्टैंड पर सफेद लैंप की छटा
fast pass tickets on bus window##bus	बस खिड़की पर तेजी से टिकट पास
an english style toilet##sink,traffic light,toilet,bottle,traffic light,sink,toilet,cup,bottle,cake	एक अंग्रेजी शैली का शौचालय
Large models in the park field##person,person,kite,kite,person,person,person,person,person,kite	पार्क क्षेत्र में बड़े मॉडल
chair is decorated with Disney characters##cup,person,bowl,bottle,spoon,dining table,dining table,potted plant	कुर्सी को डिज्नी के पात्रों से सजाया गया है
knife on the chopping block##person,person,knife,knife,bowl,bottle,oven,oven,oven,bottle	काट ब्लॉक पर चाकू
A bed of steel springs##toilet	स्टील स्प्रिंग्स का एक बिस्तर
this is a fast food place##person,person,chair,chair,dining table,chair,dining table,microwave,chair,bottle	यह एक फास्ट फूड जगह है
beige table lamp on stand##person,suitcase,book,cat,book,book,chair,chair,bed,bed	स्टैंड पर बेज टेबल लैंप
the tennis court##person,person,person,person,person,person,tennis racket,chair,person,chair	टेनिस कोर्ट
trunk of elephant forms a C##elephant,zebra,zebra,zebra,zebra,zebra,zebra,zebra,zebra,zebra	हाथी के सूंड से C बनता है
food on english muffin with yellow sauce##fork,orange,cake,cup,sandwich,dining table,cake,cup	पीले सॉस के साथ अंग्रेजी मफिन पर खाना
This part of the court is blue##person,chair,person,person,person,person,person,person,person,person	कोर्ट का यह हिस्सा नीला है
an attraction for a fair##motorcycle	एक मेले के लिए एक आकर्षण
blue box on tennis court##person,tennis racket,sports ball	टेनिस कोर्ट पर ब्लू बॉक्स
black metal plant stand##person,potted plant,couch,knife	काले धातु संयंत्र स्टैंड
the players hanging out in the dugout##person,person,person,person,person,bench,person,person,person,bench	डगआउट में बाहर घूमने वाले खिलाड़ी
Base of the yellow umbrella second from the left##umbrella,umbrella,umbrella,umbrella,umbrella,umbrella,umbrella,umbrella,umbrella,umbrella	पीले छतरी का आधार बाईं ओर से दूसरा है
the black fast forward arrow##person,couch,cell phone	काले तेजी से आगे तीर
Orange color night lamp with wooden stand##person,book,remote,book,book,book,book,book,book,book	लकड़ी के स्टैंड के साथ नारंगी रंग का नाइट लैंप
line where block fit together##person,traffic light,traffic light,tv	लाइन जहां ब्लॉक एक साथ फिट हो
bat stand in middle of bats##person,bottle,person,baseball bat,person,baseball bat,person,person,baseball bat,baseball bat	चमगादड़ के बीच में बल्लेबाजी
doilee stand is silver##cake,cake,cake,cake,cake,cake,cake,cake,cake,cake	डोली स्टैंड सिल्वर है
person on the court wearing black shirt##person,person,person,tennis racket,person,person,person,person,person,person	अदालत में काली शर्ट पहने व्यक्ति
different plane models are seen.##airplane,airplane,airplane,airplane,airplane,airplane,airplane,airplane,person,airplane	विभिन्न विमान मॉडल देखे जाते हैं।
Two press buttons of the sweater##person,toothbrush	स्वेटर के दो प्रेस बटन
Time and date stamp in corner##refrigerator,oven,microwave,knife,knife,knife,knife,knife,knife,knife	कोने में समय और तारीख मोहर
The stand of the t.v.##tv,person,bottle,book,book,book,book,book,book,book	टी। वी। का स्टैंड।
sharp knife on the chopping block##pizza,person,cup,wine glass,dining table,cup,bottle,dining table	चॉपिंग ब्लॉक पर तेज चाकू
second bird on right##bird,bird,bird	दाईं ओर दूसरा पक्षी
woman wearing dress about to cross street##person,clock,person,fire hydrant,car,person,car,car,car,car	सड़क पार करने के बारे में पोशाक पहने हुए महिला
two motor cycle springs##person,motorcycle	दो मोटर साइकिल स्प्रिंग्स
a lava lamp on stand##person,tv,remote,bottle,chair,suitcase,book,book,couch,chair	स्टैंड पर एक लावा लैंप
black springs##bird,bicycle,surfboard	काले स्प्रिंग्स
a mirror on a stand##sink,refrigerator,bowl,chair	स्टैंड पर एक दर्पण
green grass as tennis court##person,sports ball,tennis racket,person,person,person	टेनिस कोर्ट के रूप में हरी घास
antique golf clubs and stand##suitcase,suitcase,suitcase,suitcase,suitcase,suitcase,suitcase,vase,suitcase	प्राचीन गोल्फ क्लब और स्टैंड
wheels of train with springs##train,train	स्प्रिंग्स के साथ ट्रेन के पहिए
clear plastic French press##oven,microwave,refrigerator,chair,cup,cup,cup,vase	स्पष्ट प्लास्टिक फ्रेंच प्रेस
fine brown dirt##person,person,person,person,person,person,person,person,person,person	भूरे रंग की गंदगी
lifeguard stand is blue and white##truck,person	लाइफगार्ड स्टैंड नीला और सफेद है
fast food##person,person,hot dog,person,person	फास्ट फूड
a red cross on the paper##cat,refrigerator,book,cup,book,toothbrush,book	कागज पर एक लाल क्रॉस
a fast food meal served on a white plate##fork,person,sandwich,dining table,sandwich,hot dog,knife,knife,dining table,knife	एक फास्ट फूड भोजन एक सफेद प्लेट पर परोसा जाता है
Dirt is on the baseball players outfit##person,person,person,person,person,person,person,person,person,car	बेसबॉल खिलाड़ियों के आउटफिट में गंदगी होती है
A cinder block wall.##person,sheep,person,sheep,person,sheep,person,sheep,sheep,sheep	एक सिंडर ब्लॉक दीवार।
Man playing tennis on purple and green tennis court.##person,tennis racket,person,person,person,person,tennis racket,sports ball,tennis racket	मैन बैंगनी और हरे रंग की टेनिस कोर्ट पर टेनिस खेलता है।
Cartoon characters on his shirt##person,bird,frisbee,clock,car,dining table,bench,bench	उसकी शर्ट पर कार्टून पात्र
black TV stand with flat screen##chair,chair,chair,potted plant,couch,chair,vase,chair,couch,chair	फ्लैट स्क्रीन के साथ ब्लैक टीवी स्टैंड
Some people are at the county fair##person,person,person,person,person,person,kite,person,kite,person	कुछ लोग काउंटी मेले में हैं
charger stand on a desk##keyboard,laptop,keyboard,keyboard	चार्जर एक डेस्क पर है
security forces vehicle with open windows##person,airplane,person,person	सुरक्षा बल खुली खिड़कियों के साथ वाहन
Staircase leading to the second floor##chair,potted plant,chair,couch,couch,potted plant,wine glass,chair	दूसरी मंजिल की ओर जाने वाली सीढ़ी
a stand of snow covered trees##person,person,person,backpack,skis,snowboard,backpack,skis,backpack	बर्फ से ढके पेड़ों का एक स्टैंड
Three different cellphone models##cell phone,cell phone,dining table,chair,bowl,chair,chair,cell phone,person,dining table	तीन अलग सेलफोन मॉडल
this is the cross##	यह क्रॉस है
hedge bush growing outside of the tennis court##person,tennis racket	टेनिस कोर्ट के बाहर उगने वाली हेज बुश
a fine skateboard##person,skateboard,person	एक बढ़िया स्केटबोर्ड
the trees in the tennis court##person,person,tennis racket,sports ball,sports ball,sports ball,tennis racket,sports ball,sports ball,sports ball	टेनिस कोर्ट में पेड़
wood cross##bench,potted plant,bench,bench,bench,bench,bench,bench,bench,bench	लकड़ी पार
a knife block on the shelf##bottle,chair,knife,bottle,chair,chair,knife,bowl,bottle,dining table	शेल्फ पर एक चाकू ब्लॉक
line of trees to the left of the court##person,person,person,person,tennis racket,person,person,person,person,person	दरबार के बाईं ओर पेड़ों की कतार
surfer stand a surfboard##person,dog,person,surfboard,surfboard	सर्फर एक सर्फ़बोर्ड खड़ा है
date book with plastic cover##car	प्लास्टिक कवर के साथ तारीख बुक
a stamp in the wood##baseball bat,baseball bat	लकड़ी में एक मोहर
yellow time and date stamp##person,person,person,person,person,person,person,person,person,bench	पीला समय और तारीख मोहर
some kind of festival or fair##motorcycle,motorcycle,person,person,person,motorcycle,person,person,umbrella,umbrella	किसी प्रकार का त्योहार या मेला
gate/door to fence surrounding court##person,tennis racket,sports ball	गेट / दरवाजे के आसपास बाड़ लगाने के लिए अदालत
The bench the players are sitting on.##person,person,bottle,tennis racket,person,person,person,tennis racket,tennis racket,person	खिलाड़ी जिस बेंच पर बैठे हैं।
Helmet on the second horse rider.##horse,horse,person,person,dog,horse,person	दूसरे घोड़े के सवार पर हेलमेट।
poles that block entrance by large vehicles##clock,person,car	पोल जो बड़े वाहनों द्वारा प्रवेश को अवरुद्ध करते हैं
black shadow on baseball field beneath baseball players feet##person,baseball glove	बेसबॉल खिलाड़ियों के पैरों के नीचे बेसबॉल मैदान पर काली छाया
sign on brass stand##person,person,car,car,car,person,car,person,car,car	पीतल के स्टैंड पर साइन करें
Soccer players sitting on a bench##person,sports ball,person,person,person,person,person,person,person,person	एक बेंच पर बैठे फुटबॉल खिलाड़ी
the second hand of the clock##clock,fork,scissors	घड़ी का दूसरा हाथ
A girl on the tennis court is preparing to hit the ball##person,tennis racket,sports ball,baseball bat,sports ball,sports ball,sports ball,sports ball,sports ball	टेनिस कोर्ट पर एक लड़की गेंद को हिट करने की तैयारी कर रही है
brick building on a city block##car,person,person,person,person,train,person,person,person,person	शहर के ब्लॉक में ईंट निर्माण
foul lines marking the court##person,tennis racket,person,person,person,person	अदालत को चिह्नित करने वाली बेईमानी लाइनें
A large screen with information about the players.##person,tennis racket,person,person,person,person,person,person,person,chair	खिलाड़ियों के बारे में जानकारी के साथ एक बड़ी स्क्रीन।
part of a tennis court##person,sports ball,chair,baseball bat	एक टेनिस कोर्ट का हिस्सा
baseball players shoe##person,person,baseball bat,sports ball,baseball bat,person,baseball glove,baseball bat,baseball glove	बेसबॉल खिलाड़ी जूता
a golden stand for the tub##sink,sink	टब के लिए एक सुनहरा स्टैंड
the trains are toy models##train,clock,suitcase,train	ट्रेन खिलौना मॉडल हैं
baseball bat in players hands##person,person,person,baseball glove,person,person,person,person,person,person	खिलाड़ियों के हाथों में बेसबॉल का बल्ला
person in black with a camera at the side of the court##person,person,tennis racket,sports ball,person,person,person,person,person,person	अदालत के किनारे एक कैमरे के साथ काले रंग में व्यक्ति
press type electric cooking grill##chair,oven,bottle,chair,sink,bottle,dining table,bottle,bottle,potted plant	प्रेस प्रकार इलेक्ट्रिक कुकिंग ग्रिल
Award for state fair pears##apple,apple,apple,dining table,apple,apple,bowl,orange,bowl,orange	राज्य के निष्पक्ष नाशपाती के लिए पुरस्कार
players shorts are red##person,tennis racket,baseball glove	खिलाड़ी शॉर्ट्स लाल हैं
The sole of a second green shoe.##suitcase,person,cup,skateboard,fire hydrant,knife	एक दूसरे हरे रंग के जूते का तलवा
the players uniform is green and white##person,tennis racket	खिलाड़ियों की वर्दी हरे और सफेद है
The yellow vase on the second shelf on the right.##bottle,bottle,bottle,bottle,bottle,vase,vase,bottle,bottle,wine glass	दाईं ओर दूसरी शेल्फ पर पीला फूलदान।
a group of game officials at the corner of tennis court##person,person,person,person,tennis racket,person,person,person,person,handbag	टेनिस कोर्ट के कोने पर खेल अधिकारियों का एक समूह
large patch of grass next to fast food restaurant##car,umbrella,car,stop sign,car,car,stop sign,car,car	फास्ट फूड रेस्तरां के बगल में घास के बड़े पैच
Silver springs on the side of bike.##motorcycle,tie,person	बाइक के किनारे सिल्वर स्प्रिंग्स।
White copyright stamp##person,skateboard	सफेद कॉपीराइट की मुहर
the word front on the sign in the english section##person,book	इंग्लिश सेक्शन में साइन पर सामने वाला शब्द
Chinese characters on the window##person,bowl,bowl,bowl,cup,person,person,bottle,cup,person	खिड़की पर चीनी पात्र
wide brown night stand##bed,potted plant,potted plant,bench,vase,chair,vase,vase	चौड़ी भूरा नाइट स्टैंड
cartoon characters on the bottle##person,chair,dining table,donut,book,backpack,suitcase,handbag,book,chair	बोतल पर कार्टून चरित्र
top glass block in wall##sink,bottle	दीवार में शीर्ष कांच ब्लॉक
A stand with devices on it and wires behind it.##bowl,chair,couch,dining table,book,tv,book,book,book,book	इस पर उपकरणों के साथ एक स्टैंड और इसके पीछे तारों।
Several forms of public transportation##person,train,bicycle,bus,car,person,person,train,train,bus	सार्वजनिक परिवहन के कई रूप
second skateboard in picture##skateboard,person,person,person,tv,chair,skateboard,person,skateboard,bench	तस्वीर में दूसरा स्केटबोर्ड
really fast moving hand##person,person,potted plant,chair,chair,remote,remote,remote,person,chair	वास्तव में तेजी से बढ़ रहा हाथ
blue television on stand##chair,tv,bowl,dining table,chair,dining table,couch,dining table,bottle,vase	स्टैंड पर नीला टेलीविजन
The stand in the background with products the color white.##orange,orange,orange,orange,orange,orange,orange,orange,orange,orange	रंग सफेद उत्पादों के साथ पृष्ठभूमि में स्टैंड।
A big tv on a stand##couch,tv,chair,vase,potted plant,chair,dining table,chair,clock,dining table	एक स्टैंड पर एक बड़ा टीवी
group of cross country skiers##person,skis,person,person,backpack,person,snowboard	क्रॉस कंट्री स्कीयर का समूह
Screen of second laptop on desk##vase,chair,potted plant,vase,tv,laptop,laptop,chair,tv	डेस्क पर दूसरे लैपटॉप की स्क्रीन
A time stamp##banana,banana,surfboard,banana,banana,banana,banana	एक समय की मोहर
computer monitor on stand##keyboard,laptop,tv,keyboard,cup,mouse,person,book,keyboard,handbag	स्टैंड पर कंप्यूटर मोनिटर
white forms on a keyboard##tv,tv,mouse,potted plant,book,person,keyboard,book,book,book	एक कीबोर्ड पर सफेद रूप
the court is made of sand##	कोर्ट रेत से बना है
stone block building side##toilet	स्टोन ब्लॉक बिल्डिंग साइड
fence around the court.##person,tennis racket,person,person,person,tennis racket,person,tennis racket,sports ball,bench	अदालत के चारों ओर बाड़।
Blue scooter kick stand##person,person,motorcycle,motorcycle,motorcycle,chair,motorcycle	नीला स्कूटर किक स्टैंड
small patch of grass beside a tennis court##person,tennis racket,sports ball	एक टेनिस कोर्ट के पास घास के छोटे-छोटे टुकड़े
a fence between the field and players##person,person,baseball bat,person,person,baseball bat,baseball bat,person,person,person	मैदान और खिलाड़ियों के बीच एक बाड़
Sponsor signs hanging on the walls of the tennis court.##person,tennis racket	टेनिस कोर्ट की दीवारों पर प्रायोजक के निशान लटके हुए हैं।
Many stairs up to a second story.##motorcycle,chair,person	कई सीढ़ियाँ एक दूसरी कहानी तक।
section of fine gray sand##person,surfboard,surfboard	महीन भूरे बालू का खंड
Blue, yellow and white stripes on players uniform.##person,person,tennis racket,person,person,person,person,person,person,person	खिलाड़ियों की वर्दी पर नीली पीली और सफेद धारियां।
