en	bn
a bunch of books on book stand##person,person,book,handbag,book,book	বইয়ের স্ট্যান্ডে একগুচ্ছ বই
gold religious cross on top of golden ball##clock,dog,person	সোনার বলের উপরে সোনার ধর্মীয় ক্রস
Candle on glass candle stand##couch,cup,chair,wine glass,oven,bowl,potted plant,chair,vase,chair	গ্লাস মোমবাতি স্ট্যান্ডে মোমবাতি
a blue wall beside tennis court##person,tennis racket	টেনিস কোর্টের পাশে একটি নীল প্রাচীর
fine thin red hair##person,bench,vase,vase,frisbee	সূক্ষ্ম পাতলা লাল চুল
front springs of motocross motorcycle##person,motorcycle	মোটরক্রস মোটরসাইকেলের সামনের স্প্রিংস
the tennis court is made up of sand and dirt##person,tennis racket,sports ball	টেনিস কোর্ট বালু এবং ময়লা দিয়ে গঠিত
court attendant sitting in chair##person,person,chair,chair,chair,person,person,person,person,person	চেয়ারে বসে কোর্ট অ্যাটেন্ডেন্ট
a cross on the top of a spire##clock	একটি বীর্যের শীর্ষে একটি ক্রস
the cross is black##person,bus,person,person,truck,car	ক্রস কালো হয়
press box on tennis court##person,person,person,person,person,person,person,person,person,backpack	টেনিস কোর্টে প্রেস বক্স
the characters are chinese##bus,car,person,traffic light,person,person,person,person,person,person	চরিত্রগুলি চীনা
date and time of photo##sheep,sports ball	তারিখ এবং ছবির সময়
Luggage sign in english and spanish##person,suitcase,suitcase,suitcase,suitcase,suitcase,suitcase,suitcase,suitcase,suitcase	লাগেজ সাইন ইন ইংলিশ এবং স্প্যানিশ
box springs on bottom of bed##bed	বিছানার নীচে বক্স স্প্রিংস
box springs with flower print##couch,bed,person,couch,book,handbag,chair,bed,bottle,chair	ফুলের মুদ্রণ সহ বক্স স্প্রিংস
fork under english muffin##bowl,carrot,spoon,carrot,carrot,dining table,cake,sandwich,carrot,carrot	ইংরেজি মাফিনের নীচে কাঁটাচামচ
there are two players in the court##person,person,tennis racket,tennis racket,tennis racket,tennis racket	কোর্টে দুজন খেলোয়াড় আছেন
a man trying to cross##bus,bus,person,person,person,person,person,person,person,person	একজন লোক ক্রস করার চেষ্টা করছে
people on the second level##person,person,person,person,person,person,person,person,person,person	দ্বিতীয় স্তরের লোকেরা
Name and date stamp on picture##clock,refrigerator	ছবিতে নাম এবং তারিখের স্ট্যাম্প
A stand of trees.##frisbee,dog,dog	গাছের একটি স্ট্যান্ড।
umbrella to block sun##person,person,umbrella,person,chair,boat,dog,boat,person,kite	ছাতা রোদে ব্লক করতে
the woman is waiting to cross the street##person,person,person,person,car,car,car,car,car,person	মহিলা রাস্তায় পারাপারের জন্য অপেক্ষা করছেন
the lady appears to be going cross country skiing##person,person,person,backpack,backpack	ভদ্রমহিলা মনে হয় ক্রস কান্ট্রি স্কিইং যাচ্ছেন
White candle on a stand##clock,clock	একটি স্ট্যান্ডে সাদা মোমবাতি
A grey rock wall forms a boundary of the enclosure##giraffe,zebra,zebra,person	একটি ধূসর শিলা প্রাচীর ঘেরের সীমানা গঠন করে
a large block entrance##bicycle	একটি বড় ব্লক প্রবেশদ্বার
date when taken in yellow##cow,umbrella,umbrella,person,umbrella,person,person,umbrella,bench,umbrella	তারিখ যখন হলুদ নেওয়া হয়
tail of cat forms a C##cat,toilet,bottle,toilet,bottle,bottle	বিড়ালের লেজ একটি সি গঠন করে
Wooden railing on second level##clock,couch,person,person,chair,dining table,person,chair,oven,couch	দ্বিতীয় স্তরে কাঠের রেলিং
white springs boxes and gears below train engine##train,person,person	ট্রেন ইঞ্জিনের নীচে সাদা স্প্রিংস বক্স এবং গিয়ার
time and date stamp on the photograph##carrot,carrot,carrot,carrot,carrot,carrot,carrot,carrot,carrot,carrot	ছবিতে সময় এবং তারিখের স্ট্যাম্প
yellow fair pole on fence##person,person,baseball glove,tennis racket,car,bench	বেড়া উপর হলুদ ফর্সা খুঁটি
baseball players dressed in gray and orange##person,person,person,baseball glove,person,person,person,person,person,baseball glove	বেসবল প্লেয়াররা ধূসর এবং কমলা রঙের পোশাক পরা
teal sign with white asian characters##tv,person,person,person,traffic light,person,person,person,person,person	সাদা এশিয়ান অক্ষরগুলির সাথে টিল সাইন
Chain-link enclosure for tennis court##person,sports ball,sports ball,sports ball,sports ball,sports ball,sports ball,sports ball,tennis racket	টেনিস কোর্টের জন্য চেইন-লিংক ঘের
stand in the room##book,clock,book,book,book,book,book,book,book,book	রুমে দাঁড়ানো
The window on the right on the second floor.##person,person,person,car,bench,bench,bench,handbag,handbag,bench	দ্বিতীয় তলায় ডানদিকে উইন্ডো।
Date stamp of photograph##person,person	ফটোগ্রাফের তারিখ স্ট্যাম্প
large silver juice press##person,person,cup,apple,apple,apple,apple,bottle,cup,cup	বড় রূপোর জুস প্রেস
the players in the dugout##person,person,person,person,baseball glove,person,person,person,car,person	খেলোয়াড়দের ডাগআউট
A white pot on the stand##person,person,chair,person,potted plant,person,person,person,person,chair	স্ট্যান্ডে একটি সাদা পাত্র
Photo's date stamp.##person,snowboard,person	ছবির তারিখ স্ট্যাম্প।
hind leg forms one quadrant##cat	পেছনের লেগ এক চতুর্ভুজ গঠন
Light green tennis court##person,sports ball,tennis racket	হালকা সবুজ টেনিস কোর্ট
soccer players red shirt##person,person,sports ball,car,person	ফুটবল খেলোয়াড়রা লাল শার্ট
Gray television on stand##potted plant,vase,book,book,laptop,vase,tv,book,book,book	স্ট্যান্ড ধূসর টেলিভিশন
a second meal plate.##sandwich,sandwich,bowl,bottle,dining table,carrot	দ্বিতীয় খাবারের প্লেট
dark wooden wash stand##bed,vase,chair,person	গাঢ় কাঠের ওয়াশ স্ট্যান্ড
Cube-like cement block out-building with large square door##person,skateboard,bench,bench,person,person,person,bench,person,person	বড় স্কোয়ারের দরজা সহ কিউব-জাতীয় সিমেন্ট ব্লক আউট বিল্ডিং
chinese characters on a red vehicle##person,cow,motorcycle,truck	একটি লাল গাড়িতে চীনা অক্ষর
blue tennis court area##person,tennis racket,tennis racket	নীল টেনিস কোর্ট অঞ্চল
Cement block outdoor flooring.##person,chair,person,person,chair,person,suitcase,person,person,bench	সিমেন্ট ব্লক আউটডোর মেঝে
the sign has asian characters##person,person,person,person,umbrella,person,umbrella,person,person,person	সাইন এশিয়ান অক্ষর আছে
a cross sign on top of the tower##clock,clock	টাওয়ারের উপরে একটি ক্রস চিহ্ন
man is waiting to cross##car,car,traffic light,car,car,car,person,car,person,car	মানুষ ক্রস করার জন্য অপেক্ষা করছে
spikes on a players shoe##person,person,person,person,baseball glove,sports ball,baseball glove	একটি প্লেয়ার জুতো উপর কাঁটা
a museum containing models of airplanes##airplane,airplane,person,airplane,person,airplane,person,airplane,airplane,person	বিমানগুলির মডেল সমন্বিত একটি যাদুঘর
date and time stamp on a picture##truck,car,truck,oven	একটি ছবিতে তারিখ এবং সময় স্ট্যাম্প
Chinese characters on sign##traffic light	সাইন ইন চীনা অক্ষর
an orange sign with written characters##car,person,person,person,person,car,car,person,person,person	লিখিত অক্ষরের সাথে একটি কমলা চিহ্ন
Baseball players are in the background##person,person,baseball glove,person,person,baseball bat,person,person,person,person	বেসবল প্লেয়াররা পটভূমিতে রয়েছে
Newspaper stand on the grass##car,car,truck,car,car,car,car,car,car,car	খবরের কাগজ ঘাসে দাঁড়িয়ে আছে
young female date wearing a purple rhinestone sleeveless gown##person,person,person,tie,potted plant,tie	বেগুনি কাঁচের কাঁচের স্লিভলেস গাউন পরা তরুণ মহিলা তারিখ 
two people waiting to cross##person,person,traffic light,umbrella,car,person,car,fire hydrant,umbrella,handbag	দুই জন ক্রস করার জন্য অপেক্ষা করছে
the side of the second train##train	দ্বিতীয় ট্রেনের পাশ
the bird is stand on a tree branch##bird,bear	পাখি গাছের ডালে দাঁড়িয়ে আছে
a black cross on a vertical stabilizer##person,airplane,person,tennis racket,backpack,cup,stop sign,person,potted plant	একটি উল্লম্ব স্ট্যাবিলাইজারের উপর একটি কালো ক্রস
a green tennis court##person,tennis racket,sports ball	একটি সবুজ টেনিস কোর্ট
neutral makeup on both rain models##umbrella,person,person,umbrella,car,person,person,book,toothbrush,truck	উভয় বৃষ্টি মডেল নিরপেক্ষ মেকআপ
the second bus has a blue sign##bus,bus,person,person,person,car,car,person,bus,person	দ্বিতীয় বাসটিতে একটি নীল চিহ্ন রয়েছে
This is some type of a fair.##person,person,person,dog,motorcycle,dog,person,person,person,person	এটি মেলার এক প্রকার।
A display of different phone models##cell phone,cell phone,cell phone,cell phone,cell phone,cell phone,cell phone,cell phone,cell phone,cell phone	বিভিন্ন ফোনের মডেলগুলির প্রদর্শন
microphone on the court##person,person	কোর্টে মাইক্রোফোন
person doing a hand stand##laptop,laptop,laptop,person,book,book,person,person,keyboard,keyboard	ব্যক্তি একটি হাত স্ট্যান্ড করছেন
springs of the seat##motorcycle,person,person,person,handbag,person,knife,motorcycle,clock	আসন স্প্রিংস
A large pipe extending from the wall of the court.##person,tennis racket,potted plant,vase	কোর্টের দেয়াল থেকে প্রসারিত একটি বৃহত পাইপ।
rapid in fast water##person,surfboard	দ্রুত জলে দ্রুত
a stone block train platform##train,suitcase,person,person,person,person,person,person,train,train	একটি পাথর ব্লক ট্রেন প্ল্যাটফর্ম
a book is on the night stand##bed	একটি বই নাইট স্ট্যান্ডে আছে
orange springs on the bottom of train##train,person,person,traffic light,person,chair,chair,person	ট্রেনের নীচে কমলা ফোয়ারা
a fast flowing river##bird	একটি দ্রুত প্রবাহিত নদী
lighted signs for different forms of public transportation##clock,clock	জনসাধারণের যাতায়াত বিভিন্ন ধরণের জন্য আলোকিত লক্ষণ
three windows on the second floor##clock,potted plant	দ্বিতীয় তলায় তিনটি জানালা
a dark blue sedan moving fast##car,traffic light,traffic light,traffic light,traffic light,stop sign,tv,traffic light	গাঢ় নীল রঙের সেডান দ্রুত গতিতে চলছে
zebras stand close together to watch for predators##zebra,zebra,zebra	শিকারীরা দেখার জন্য জেব্রা একসাথে দাঁড়িয়ে আছে
Gated street fair##car,person,person,person,person,person,person,person,traffic light,person	গেটেড স্ট্রিট মেলা
surfboard forms a splash of water##person,surfboard,person,surfboard	সার্ফবোর্ড জল স্প্ল্যাশ গঠন
paper triangle stand##toilet,sink,toilet,cup,sink	কাগজের ত্রিভুজ স্ট্যান্ড
a time and date stamp##traffic light,traffic light,traffic light,car,traffic light,car,traffic light	একটি সময় এবং তারিখ স্ট্যাম্প
english letter is white##person,person,car,fire hydrant,handbag,person,handbag,umbrella,fire hydrant,person	ইংরেজি বর্ণ সাদা
Brown box is on the tennis court##person,tennis racket,sports ball,sports ball,sports ball,sports ball,sports ball,chair,bench,bench	ব্রাউন বক্স টেনিস কোর্টে রয়েছে
a cross is on the tower##person,cow,cow,cow,cow,cow,cow,dog	একটি ক্রুশ টাওয়ারের উপরে রয়েছে
players in dirt circle##person,person,person,baseball glove,baseball glove	ময়লা বৃত্তের খেলোয়াড়
beige stair way going to second level##potted plant	বেইজ সিঁড়ি উপায় দ্বিতীয় স্তরে যাচ্ছে
grey concrete cross by the building##clock,clock	বিল্ডিং দ্বারা ধূসর কংক্রিট ক্রস
block for bench feet##bench,potted plant,potted plant,potted plant	বেঞ্চ ফুট জন্য ব্লক
location characters are white##train	অবস্থানের অক্ষরগুলি সাদা
Brown plastic fast food table##donut,bottle,dining table,remote,chair,car,chair,sandwich	ব্রাউন প্লাস্টিকের ফাস্ট ফুড টেবিল
The TV and stand in the living room##couch,couch,chair,chair,chair,chair,chair,tv,chair,couch	বসার ঘরে টিভি এবং স্ট্যান্ড
brown wooden stairs leading to second floor##person,backpack,book,book,book,book,book,book,book,couch	বাদামি কাঠের সিঁড়ি দিয়ে দোতলা যাওয়া যায়
very fine fabric and material##scissors	খুব সূক্ষ্ম বুনন এবং কাপড়
do not block intersection sign is above the right lane must turn right sign##bus,person,person,person,car,car,person,person,traffic light,person	ছেদটি অবরোধ করবেন না সাইনটি ডান দিকেই যান সাইন এর উপরে আছে
The motorcycles are going fast##motorcycle,motorcycle,person,person,person,motorcycle	মোটর সাইকেলগুলো দ্রুত চলছে
a fence behind the players##person,person,person,baseball bat,baseball bat	খেলোয়াড়দের পিছনে একটি বেড়া
the date on the photo##bear	ফটোর উপরে তারিখ
the penalty box is white lined##sports ball,person,person,person,person,person,person,person,person,person	পেনাল্টি বক্সটি সাদা রেখা দ্বারা চিহ্নিত
the green sign with red and yellow characters##person,umbrella,person,umbrella,person,umbrella,person,umbrella,person,person	সবুজ সাইন এর মধ্যে লাল এবং হলুদ হরফ
A red metal frame forms the half pipe##person,skateboard	একটি লাল ধাতব ফ্রেম দিয়ে অর্ধেক পাইপ টি তৈরী 
shadows of players on court##person,person,tennis racket,car,person,person	কোর্টে খেলোয়াড়দের ছায়া
a red tennis shoe on players foot##person,tennis racket,skateboard,person,person,person,skateboard	খেলোয়াড় এর পায়ে একটি লাল টেনিস জুতো
clock face on wall date##clock,clock,clock	দেয়াল এর ঘড়িতে তারিখ 
a group of people watching the baseball players##person,person,person,person,baseball bat,baseball glove,person,person,backpack,person	বেসবল খেলোয়াড়দের দেখছেন একদল লোক
a woman on the opposite team trying to block the frisbee##person,person,person,frisbee	বিপক্ষ দলের এক মহিলা ফ্রিসবি আটকানোর চেষ্টা করছেন 
a white stand on road##car,car,car,car	রাস্তায় একটি সাদা স্ট্যান্ড
Concrete forms in pavement##person,person,bench,motorcycle,bench,potted plant,book,person,bench,book	ফুটপাতে কংক্রিট ফর্ম
man standing next to fruit stand##person,person,person,person,clock,person,person,banana,banana,banana	মানুষটি ফল স্ট্যান্ড এর পাশে দাঁড়িয়ে 
A bed plastic stamp##suitcase,bed	বিছানাতে প্লাস্টিকের স্ট্যাম্প
girl showing cow at fair##cow,person,person,bench,person,person,person,person,person,person	মেলায় গরু দেখাচ্ছে মেয়ে
judge on side of court on blue platform##person,person,person,person,person,person,tennis racket,person,person,clock	কোর্ট এর এক পাশে নীল প্লাটফর্ম এ বিচারক 
The top white cross.##cow,motorcycle,person,person,person,motorcycle,person,bicycle,person,cow	শীর্ষ সাদা ক্রস।
Dirt on the players pants.##person,person,baseball bat,person,person,baseball glove,person,person,person,person	খেলোয়াড়দের প্যান্টের উপর ময়লা।
chain-linked fence behind players##person,frisbee,person,person,person,person,person,person,person,person	খেলোয়াড়দের পেছনে চেইন-লিঙ্কযুক্ত বেড়া
White paper on a black stand##couch,potted plant,vase,book,vase,chair	একটি কালো স্ট্যান্ড উপর সাদা কাগজ
March 7th is the date on the calendar##book,sink,book,book,book,vase,cup,book,book	৭ই মার্চ ক্যালেন্ডারে তারিখ
Tray of white rice and english muffins##person,bowl,dining table,bowl,banana,spoon,spoon,dining table,spoon,bowl	সাদা ভাত এবং ইংলিশ মাফিনের ট্রে
a iron stand on back##teddy bear,dog,bed	পিছনে একটি লোহার স্ট্যান্ড
red hat on baseball players head##person,person,person,baseball glove,baseball bat,baseball glove,cup,cup,sports ball,baseball bat	বেসবল খেলোয়াড় এর মাথায় লাল টুপি 
black and white tennis court netting##person,person,tennis racket,person,person,sports ball,person,chair,person,person	টেনিস কোর্ট এর সাদা এবং কালো জালের বুনানি
second set of closed umbrellas##chair,chair,chair,chair,chair,person,person,chair,person,chair	বন্ধ ছাতার দ্বিতীয় সেট 
Bright red semi-gloss block wall##toilet,toilet	উজ্জ্বল আধা মসৃন লাল দেয়াল ব্লক 
Three baseball players are in the field.##person,person,person,baseball glove,baseball glove	তিনজন বেসবল খেলোয়াড় মাঠে আছেন 
A block wall is behind the skate park##person,skateboard,person	স্কেট পার্কের পিছনে একটি ব্লক প্রাচীর রয়েছে
tail fine view of a red plane##airplane,airplane,person	একটি লাল বিমানের লেজ সূক্ষ্ম দর্শন
a group of ball players practicing##person,person,person,person,person,person,person,person,person,baseball bat	একটি বল খেলোয়াড়দের দল অনুশীলন করছে 
a fine silver pocket watch##clock	একটি সূক্ষ্ম রুপার পকেট ঘড়ি
the date stamp in the corner of the pic##zebra,zebra,zebra,zebra,zebra,zebra,zebra,zebra,car,zebra	ছবিটির কোণায় তারিখ স্ট্যাম্প
Red circle with white cross under right wing##airplane	ডান ডানা নীচে সাদা ক্রস সঙ্গে লাল বৃত্ত
a metal stand for the flowers##bowl,book,sink,potted plant,sink	ফুলের জন্য একটি ধাতব স্ট্যান্ড
A light reflecting on a tie press.##vase,suitcase,suitcase,refrigerator,bowl,oven,donut,cell phone,cell phone,suitcase	একটি টাই প্রেসে আলো প্রতিফলিত হচ্ছে 
loose sediment forms on the rocks##bird,bird,bird,bird,bird,bird,bird,bird,bird,bird	পাথরের উপর আলগা পলি ফর্ম
the hand is going to press a button##cell phone,person,person,dining table	হাত একটি বোতাম টিপতে যাচ্ছে
sign written in english and foreign language##traffic light,potted plant	ইংরেজি এবং বিদেশী ভাষায় লিখিত সাইন
yellow stamp date near bottom##person,person,person,remote,cup,donut,couch,donut,donut,donut	নীচে কাছাকাছি হলুদ স্ট্যাম্প তারিখ
Street sign on a pole in english and chinese##stop sign	একটি স্ট্যান্ডের উপরে ইংলিশ এবং চীনা ভাষায় একটি রাস্তার সাইন
an english muffin sandwich##cup,potted plant,sandwich,dining table,cup,bottle,vase,bottle,cat,chair	একটি ইংরেজি মাফিন স্যান্ডউইচ
many utility cables cross over the street##car,car,car,car,car,car,car	অনেক ইউটিলিটি তারগুলি রাস্তায় অতিক্রম করে
block sneakers with green laces##skateboard,bicycle,person,bicycle,bicycle,bicycle,bicycle,bicycle,bicycle,bicycle	সবুজ লেইস সঙ্গে স্নিকার ব্লক
Brown painted signature and date.##person,horse,person	বাদামি স্বাক্ষর এবং তারিখ আঁকা।
woman is behind the white line of a tennis court##person,person,person,person,person,person,person,sports ball,person,person	টেনিস কোর্টের সাদা লাইনের পিছনে মহিলা রয়েছেন
a sign showing cross streets##suitcase	ক্রস রাস্তা দেখানো একটি চিহ্ন
farmer's market stand##broccoli,broccoli,broccoli,broccoli,carrot,broccoli,broccoli,broccoli,broccoli,broccoli	কৃষকের বাজার স্ট্যান্ড
banana on the stand##bird,banana,banana,bird,bird,banana,banana,banana,banana,banana	স্ট্যান্ডে কলা
logo stamp on the door##refrigerator,suitcase,cup	লোগো স্ট্যাম্প দরজা
english breakfast tea text##cup,book,book,book,person,clock,dining table,scissors	ইংরেজী প্রাতঃরাশের চা পাঠ্য
Black bike seat with silver springs.##banana,bicycle,banana,banana,person,banana,banana,banana,banana,banana	সিলভার স্প্রিংস সহ কালো সাইকেলের সিট।
white sign with blue asian characters on it##umbrella,person,car,stop sign,truck,car,car,car,traffic light	এটিতে নীল এশিয়ান অক্ষরগুলির সাথে সাদা চিহ্ন
Big springs on the bottom of train.##train	ট্রেনের নীচে বড় স্প্রিংস।
Small French coffee press.##person,wine glass,dining table,bowl,bowl,cup,cup,bowl,cup,cup	ছোট ফরাসি কফি প্রেস।
Landline phone on the night stand##bed,clock,bed,remote,vase,remote,remote,remote	নাইট স্ট্যান্ডে ল্যান্ডলাইন ফোন
A tin container decorated with Star Wars characters and themes##vase,potted plant,apple,person	স্টার ওয়ার্সের অক্ষর এবং থিম দিয়ে সজ্জিত একটি টিনের পাত্রে
The players shoes are black.##person,baseball glove,sports ball,sports ball	খেলোয়াড়দের জুতো কালো।
Sis car models on top of each other##person,person,person,person,car,car,bench,handbag,airplane,car	একে অপরের শীর্ষে সিস কার মডেল
date of the recording##motorcycle,person	রেকর্ডিংয়ের তারিখ
a second pizza in a pan##cup,pizza,pizza,pizza,cup,dining table,knife,bottle,bottle,fork	একটি প্যানে দ্বিতীয় পিজ্জা
cross walk lines on street##person,car,traffic light,car,traffic light,traffic light	রাস্তায় ক্রস ওয়াক লাইন
two man standing on a tennis court##person,person,tennis racket,tennis racket	টেনিস কোর্টে দাঁড়িয়ে দুই ব্যক্তি
Cell phone is in stand.##mouse,laptop,tv,keyboard,book,book,cup,keyboard,keyboard	সেল ফোন দাঁড়িয়ে আছে।
Blue section of tennis court##person,tennis racket,sports ball	টেনিস কোর্টের ব্লু বিভাগ
A white plate with english muffins##sandwich,sandwich,dining table,bowl	ইংলিশ মাফিনস সহ একটি সাদা প্লেট
A block in the wall.##motorcycle	দেয়ালে একটি ব্লক।
a red sign advertising a fun fair##person,car,car,person,person,person,person,car,car,person	একটি লাল চিহ্ন একটি মজার মেলার বিজ্ঞাপন
a cross on the front of a church##bus,person,bicycle,car,person,car,traffic light,car,truck,car	একটি গির্জার সামনে ক্রস
the fence covered in netting at the end of the court##person,person,person,person,sports ball,sports ball,tennis racket,tennis racket,tennis racket,tennis racket	কোর্টের শেষে জাল দিয়ে বেড়ানো ঢাকা বেড়া
Small section of baseline on a tennis court##person,person,sports ball,sports ball,tennis racket,tennis racket	টেনিস কোর্টে বেসলাইনের ছোট্ট বিভাগ
a platter of fine china##refrigerator,hot dog,bowl,cup,spoon,cup,spoon,cup,bottle,bottle	সূক্ষ্ম চীন একটি থালা
Grey cross on a green dome top.##traffic light,car,car,car,car,car,car,car,car,car	সবুজ গম্বুজ শীর্ষে ধূসর ক্রস।
fading on the court##person,person,person,person,person,person,person,person,person,person	কোর্টে বিবর্ণ
The date 01/03/2008 in yellow.##person,handbag,person	হলুদে ০১/০৩/২০০৮ তারিখ।
information stamp on image##person,horse,person,person,person,person,person,horse,horse,person	ছবিতে তথ্য স্ট্যাম্প
yellow safety tape at a tennis court##person,person,person,person,sports ball,tennis racket,sports ball,sports ball,tennis racket,sports ball	টেনিস কোর্টে হলুদ সুরক্ষা টেপ
Balconies on the second story of the buildings##motorcycle,motorcycle,person,car,motorcycle,person,car,car,person,person	বিল্ডিংগুলির দ্বিতীয় গল্পের উপর বালকনিগুলি
Shades of the second biker##motorcycle,person,motorcycle,person	দ্বিতীয় বাইকারের ছায়া
a small black entertainment stand##laptop,couch,couch,remote,tv,dining table,keyboard,book	একটি ছোট কালো বিনোদন স্ট্যান্ড
thumb press into a doughnut##donut,person,person	একটি ডোনাট মধ্যে থাম্ব প্রেস
The line on the tennis court is white.##person,tennis racket	টেনিস কোর্টের লাইনটি সাদা।
mini hi-fi on small stand##laptop,tv,couch,book,book,cup,book,bowl,cup,book	ছোট স্ট্যান্ডে মিনি হাই ফাই
two people stand next to the boat##bird,person,person,boat,boat,person,person,person,person,person	দু'জন লোক নৌকার পাশে দাঁড়িয়ে
an english taxi cab is on the bridge##clock,person,person,person,clock,person,person,car,person,car	একটি ইংরেজী ট্যাক্সি ক্যাব ব্রিজের উপরে রয়েছে
white TV stand on floor##person,person,tv,person,remote,remote,book,remote,person	ফ্লোরে সাদা টিভি স্ট্যান্ড
cross that sits atop the column on the left side##clock	বাম দিকে কলামের উপরে বসে যে ক্রস
Two baseball players at the plate##person,person,sports ball,baseball glove,baseball glove	প্লেটে দুটি বেসবল খেলোয়াড়
photo date on right##motorcycle,car,car,car,car,car,car,person,person,car	ডানদিকে ছবির তারিখ
a fine meal on a plate##broccoli,person,spoon,knife,spoon,dining table,sandwich,broccoli,fork	একটি প্লেটে একটি চমৎকার খাবার
a glass block window##person,book,book,tie,book,book,suitcase	একটি গ্লাস ব্লক উইন্ডো
time and date stamp on the picture##person,person,bed,person,dog	ছবিতে সময় এবং তারিখের স্ট্যাম্প
sing is written in chinese and latin characters##person,car,potted plant	গান চীনা এবং লাতিন অক্ষরে লেখা হয়
fine, pale sand##person,sports ball,person,person,kite	ঠিক আছে, ফ্যাকাশে বালু
cone of plane appears dark, shiny and fast##airplane,person,person	সমতল শঙ্কু অন্ধকার, চকচকে এবং দ্রুত প্রদর্শিত হবে
round light gray large cement block##frisbee,person,person,person,person,person,person,person,person,person	গোলাকার হালকা ধূসর বড় সিমেন্ট ব্লক
Large tv on black stand.##tv,potted plant,dining table,couch,book,oven	কালো স্ট্যান্ডে বড় টিভি।
soccer players connect chin and forehead##person,person,sports ball,person	ফুটবল খেলোয়াড়রা চিবুক এবং কপাল সংযোগ করে
a round wooden block##vase,couch,potted plant,cake	একটি বৃত্তাকার কাঠের ব্লক
a juice press##person,knife,person,orange,cup,person,cup,chair,orange,orange	একটি রস প্রেস
Railing on second floor of building##person,person,person,person,person,person,person	বিল্ডিংয়ের দ্বিতীয় তলায় রেলিং
white paper with pictures on stand on the table##chair,chair,dining table,potted plant,bottle,oven,chair,bottle,potted plant,dining table	টেবিলের উপর স্ট্যান্ডে ছবি সহ সাদা কাগজ
items for sale in stand##person,umbrella,person,umbrella,umbrella,umbrella,person,book,umbrella,chair	স্ট্যান্ড বিক্রয়ের জন্য আইটেম
ridged metal pole stand to a large clock##clock	উত্তেজিত ধাতব মেরু একটি বড় ঘড়ির জন্য দাঁড়িয়ে
Silver metal monitor stand##person,person,person,chair,chair,person,tv,kite,person,dining table	সিলভার মেটাল মনিটর স্ট্যান্ড
Landscape shrub models on display##truck,truck	ডিসপ্লেতে ল্যান্ডস্কেপ গুল্ম মডেল
these are baseball players##person,person,baseball glove,tennis racket,kite	এই বেসবল খেলোয়াড়
Cinder block base for fence##giraffe,giraffe,giraffe,giraffe	বেড়া জন্য সিন্ডার ব্লক বেস
A net in between the players##person,person,person,person,person,person,person,person,person,person	খেলোয়াড়দের মধ্যে একটি নেট
the blue 28 on the back of the players shirt##person,person,baseball glove	প্লেয়ারদের শার্টের পিছনে নীল 28
the second level of the bus##bus,person,person	বাসের দ্বিতীয় স্তর
characters on the billboard##person,person,person,umbrella,person,person,umbrella,person,umbrella,person	বিলবোর্ডে অক্ষর
The bolt underneath the springs.##bicycle,bicycle,person,bottle	ঝর্ণার নীচে বল্টু।
The net on a tennis court##person,person,tennis racket,tennis racket,sports ball,person,person,sports ball	টেনিস কোর্টে নেট
older dude on bicycle in a country where spanish/english are the official languages##person,stop sign,bicycle,car,traffic light,car,car,car,person,car	এমন দেশে সাইকেলের উপর বয়স্ক ছেলেমেয়েরা স্প্যানিশ / ইংরেজি সরকারী ভাষা
Several models hanging in the air in the exhibit##kite,kite,kite,kite,kite,kite,kite,kite,kite,kite	প্রদর্শনীতে বাতাসে ঝুলন্ত বেশ কয়েকটি মডেল
black utensils in a wooden block##person,oven,cup,microwave,spoon,knife,bowl,dining table,cup,cup	একটি কাঠের ব্লক কালো পাত্রে
bird second in line##book,bird,bird,bird,bird,book	লাইনে পাখি দ্বিতীয়
english flag printed umbrella##person,person,umbrella,person,person,umbrella,umbrella,umbrella,umbrella,umbrella	ইংরেজি পতাকা ছাতা ছাতা
stamp on boy's left hand##person,person,teddy bear,teddy bear,person,person,sports ball,teddy bear	ছেলের বাম হাতে স্ট্যাম্প
person holding a block of ice##cow,person,person,person,person,person	বরফের ব্লক ধরে থাকা ব্যক্তি
large green and purple tennis court##person,person,person,tennis racket,person,bottle,tennis racket,person,chair,chair	বড় সবুজ এবং বেগুনি টেনিস কোর্ট
A man taking a picture of the players.##person,person,person,chair,chair,person,tennis racket,chair,chair,chair	খেলোয়াড়দের ছবি তুলছেন এক ব্যক্তি।
Yellow time and date stamp##person,person,person,person,clock,person,person,handbag,bicycle,bicycle	হলুদ সময় এবং তারিখ স্ট্যাম্প
a fair weather cloud##truck,bus	একটি আবহাওয়া মেঘ
orange date print##person,person,person,person,person,person,person,backpack,person,person	কমলা তারিখ মুদ্রণ
tennis players shaking hands##person,tennis racket,cell phone,person,person,person,person,person,chair,person	টেনিস খেলোয়াড়রা হাত কাঁপছেন
the block of hay##zebra,zebra,zebra,zebra	খড়ের ব্লক
there is a building behind the court##person,person,tennis racket,bench,bench,tennis racket,bench,bench,bench	কোর্টের পিছনে একটি বিল্ডিং রয়েছে
proprietor of the mobile lemonade stand##person,skateboard,person,person,person,car,car,umbrella,cell phone,cell phone	মোবাইল লেবুনেড স্ট্যান্ডের স্বত্বাধিকারী
pole behind second baseman##person,person,person,person,person,person,person,person,baseball bat,stop sign	দ্বিতীয় বেসম্যান পিছনে মেরু
Net separating a tennis##person,tennis racket,person,sports ball,person	নেট একটি টেনিস পৃথক
A table full of fine china.##cake,vase,vase,vase,vase,vase,vase,vase,vase,cake	একটি সূক্ষ্ম চীন পূর্ণ টেবিল।
The items on the top shelf have painted characters on them##person,vase,vase,vase,vase,vase,donut,truck	উপরের শেল্ফের আইটেমগুলিতে অক্ষরগুলি আঁকিয়েছে
date palms on the grassy field##car	ঘাসের মাঠে খেজুর
ground where bike stand##motorcycle,motorcycle,motorcycle,motorcycle,motorcycle,motorcycle,motorcycle,car,motorcycle,bicycle	সাইকেল যেখানে দাঁড়িয়ে আছে
the players are wearing cleats on their shoes##person,person,person,person,person,baseball glove,baseball glove,person,chair,person	প্লেয়াররা তাদের জুতোতে ক্লিট পরে আছে
green shrubbery that forms a circle around the pedestal##clock,clock,car,car,car,car	পাদদেশের চারপাশে একটি বৃত্ত তৈরি করে এমন সবুজ ঝোপঝাড়
crosswalk for pedestrians to cross##person,person,person,person,umbrella,umbrella,person,backpack,car,person	পথচারীদের পারাপারের জন্য ক্রসওয়াক
one side is in english##stop sign,traffic light	এক দিক ইংরেজিতে
The water bottle on the stand##bottle,person,suitcase,suitcase,oven,person,chair	স্ট্যান্ডে জলের বোতল
pair of hands typing fast on keyboard##tv,keyboard,person,book,chair	হাত জোড় কীবোর্ডে টাইপ করা
second level of building##clock,chair,chair,chair,chair,tv,chair,chair,bench	বিল্ডিং দ্বিতীয় স্তর
second man looking over first's shoulder##person,tie,person	দ্বিতীয় ব্যক্তি প্রথম কাঁধের উপর তাকিয়ে
The birds are flying fast##bird,bird,bird,bird,bird	পাখিরা দ্রুত উড়ছে
time stamp in corner of image##person,person,skis,snowboard,backpack,skis	চিত্র কোণে সময় স্ট্যাম্প
light stand beside bed##bed,bed	বিছানার পাশে হালকা স্ট্যান্ড
date 01/05/2011##cat,tv	তারিখ ০১/০৫/২০১১
this court is green##person,person,person,sports ball,person,person,sports ball	এই কোর্ট সবুজ
a table filled with assorted models and tools##keyboard,train,bowl,keyboard,chair,dining table,bottle,bus	বিভিন্ন মডেল এবং সরঞ্জাম দিয়ে ভরা একটি টেবিল
The cave the wave forms.##person,surfboard	গুহাটি তরঙ্গ গঠন করে।
baseball players helmet##person,person,person,person,person,person,baseball bat,baseball glove,baseball glove	বেসবল খেলোয়াড় হেলমেট
Large cross outside of a church.##bus,person,person,person,bicycle,bicycle,person,person,person,bicycle	একটি গির্জার বাইরে বড় ক্রস।
fence on a baseball court##person,baseball bat,baseball bat,person,baseball bat,baseball bat,baseball bat,baseball glove,baseball bat,bench	বেসবল কোর্টে বেড়া
large green bench press on the table##bottle,bottle,fire hydrant,oven,vase	টেবিলের উপর বড় সবুজ বেঞ্চ প্রেস
second car attached to train engine##train,train,train	ট্রেন ইঞ্জিনের সাথে সংযুক্ত দ্বিতীয় গাড়ি
a white line cross walk.##horse,horse,traffic light,person,traffic light,person,traffic light,horse,traffic light,traffic light	একটি সাদা লাইন ক্রস ওয়াক।
expiration date in black ink##banana,banana,banana,banana,banana,banana,banana,banana,banana,banana	কালো কালি শেষ হওয়ার তারিখ
box springs under a bed##person,person,bed,person	একটি বিছানার নীচে বক্স স্প্রিংস
white graffiti on a stand##umbrella,cup,bottle,bottle,cup,bowl,bottle,bowl,potted plant	স্ট্যান্ডে সাদা গ্রাফিটি
block behind the woman##person,cow,elephant,cup,cow	মহিলার পিছনে ব্লক
Glass safety rail on second floor.##clock,person,suitcase,suitcase,person,person,person,person,suitcase,suitcase	দ্বিতীয় তলায় গ্লাস সুরক্ষা রেল।
White marking on the court##person,person,sports ball,sports ball,person,person,tennis racket,tennis racket,car,tennis racket	কোর্টে সাদা চিহ্ন
bolt on cross walk sign##traffic light,stop sign,scissors	ক্রস ওয়াক সাইন উপর বল্টু
a white line a cross the field##person,person,person,baseball bat,baseball glove	একটি সাদা লাইন একটি ক্ষেত্র পেরিয়ে
players wearing knee-high socks##person,person,person,person,person,sports ball	খেলোয়াড়রা হাঁটু-উচ্চ মোজা পরা
second man skiing in snow##person,person,backpack,skis,skis,backpack,skis,skis	তুষার দ্বিতীয় স্কিইং
a few people about to cross the road##traffic light,car,car,person,person,traffic light,person,person,car,car	কিছু লোক রাস্তা পার হতে চলেছে
stop sign in english and farsi##stop sign	ইংরেজি এবং ফারসি সাইন ইন করুন
a rounded edged wood block##bowl,bottle,pizza,dining table,bowl,bowl,bottle,bowl,bottle,pizza	একটি বৃত্তাকার ধারযুক্ত কাঠের ব্লক
Television set on wooden stand##person,tv,book,book,book,book	কাঠের স্ট্যান্ডে টেলিভিশন সেট
Four players standing on a tennis court##person,person,tennis racket,person,person,sports ball,bench,car,car	টেনিস কোর্টে দাঁড়িয়ে চারজন খেলোয়াড়
the tv stand is blacjk incolor##tv,person,cup	টিভি স্ট্যান্ডটি ব্ল্যাকজক ইনক্লোর
a team of good soccor players.##person,person,person,person,sports ball,person,sports ball,sports ball,frisbee,sports ball	ভাল সকার খেলোয়াড়দের একটি দল।
the angel is holding a cross shield##clock,person,person,clock,person	দেবদূত একটি ক্রস ঢাল ধরে আছে
a cross on the top of the building##clock	বিল্ডিংয়ের উপরে একটি ক্রস
players watch from the dugout##person,baseball glove,person,person,baseball glove,person,person,person,person,person	খেলোয়াড়রা ডাগআউট থেকে দেখুন
stand full of baseball fans##person,person,person,person,baseball glove,baseball bat,person,person,person,person	বেসবল ভক্তদের পূর্ণ দাঁড়িয়ে
The cat is looking at the second cat.##cat,cat	বিড়াল দ্বিতীয় বিড়ালের দিকে তাকাচ্ছে।
People with umbrellas waiting to cross the street.##person,umbrella,person,car,car,person,person,umbrella,umbrella,umbrella	রাস্তা পার হওয়ার অপেক্ষায় ছাতাওয়ালা লোকেরা।
red ground of a tennis court##person,person,tennis racket,tennis racket,tennis racket,stop sign	টেনিস কোর্টের লাল গ্রাউন্ড
the second hand on the clock##clock,sink,vase,person	ঘড়ির উপর দ্বিতীয় হাত
the small cross on top of the headstone##	হেডস্টোন উপরে ছোট ক্রস
White cross walk in road##traffic light,person,traffic light,car,bus,car	রাস্তায় সাদা ক্রস ওয়াক
rusty springs beneath 'schwinn'##cat,bicycle,person,chair,person,bicycle	'স্কুইন' এর নীচে মরিচা ঝর্ণা
truck has two white Chinese characters##truck,bus,car,truck,car,car,truck,person,bus,car	ট্রাক দুটি সাদা চীনা অক্ষর আছে
a bunch of baseball players waiting for their turn##person,person,person,person,person,person,person,person,person,train	বেসবল খেলোয়াড়দের একগুচ্ছ তাদের পালনের জন্য অপেক্ষা করছে
The sign is in arabic and english##stop sign,boat,car,boat,boat,car,person	সাইন আরবী এবং ইংরেজী ভাষায়
a copy of vanity fair is displayed##person,person,person,person,person,person,bottle,person,tie,person	ভ্যানিটি মেলার একটি অনুলিপি প্রদর্শিত হয়
the fine is 350 usd##car,person,car,car,car,car,truck,motorcycle,person	জরিমানা 350 ইউএসডি হয়
a black second hand##clock,car,car,traffic light	একটি কালো দ্বিতীয় হাত
A postage stamp.##laptop,mouse,book,book,dining table,bowl,keyboard,book,book,scissors	একটি ডাকটিকিট
advertisement on tennis court##person,tennis racket	টেনিস কোর্টে বিজ্ঞাপন
A fruit stand on the sidewalk##dog,parking meter,apple,apple,apple,apple,apple	ফুটপাতে একটি ফল স্ট্যান্ড
fair large legion of anti-climate change, 350.org, kites with tails in the overcast sky##person,person,person,person,person,kite,kite,person,person,person	জলবায়ু পরিবর্তন বিরোধী ন্যায্য বৃহত্তর সৈন্যদল, 350.org, মেঘলা আকাশে লেজযুক্ত ঘুড়ি
the banana hanging from the stand##banana,chair,clock,dining table,couch	স্ট্যান্ড থেকে কলা ঝুলছে
a church tower with a cross on the roof##person,person,person,bicycle,bicycle,car,person,bicycle,bicycle,person	ছাদে ক্রস সহ একটি গির্জার টাওয়ার
Lid of glass cake stand##cake,dining table,wine glass	কাচের কেক স্ট্যান্ডের ঢাকনা 
member of opposing team trying to block the shooter's shot##person,person,person,person,person,person,person,person,person,person	বিরোধী দলের সদস্য শ্যুটারের শটটি ব্লক করার চেষ্টা করছেন
the stand is stable##person,microwave	স্ট্যান্ড স্থিতিশীল
batter being poured into a waffle press##person,person,person,person,person,person,person,person,person,banana	তরল কাই ওয়াফল প্রেস এ ঢালা হচ্ছে
black metal fence behind a tennis court##person,tennis racket,person,person,person	টেনিস কোর্টের পিছনে কালো ধাতব বেড়া
cross on the church roof##clock,person,person,person,person,person,person	গির্জার ছাদ উপর ক্রস
clock on the pole##clock	মেরু উপর ঘড়ি
the second young lady is wearing capri-style jeans##person,person,dog,frisbee,potted plant,clock	দ্বিতীয় যুবতী ক্যাপরি স্টাইলের জিন্স পরেছেন
The blue tennis court##person,tennis racket	নীল টেনিস কোর্ট
Angels overlooking the cross##bench,bench,bench,person,bench,bench,bench,chair,bench,chair	দেবদূতরা ক্রসকে অগ্রাহ্য করে
black Samsung tv on the tv stand##tv,person,book,book,book,book,book,book,book,book	কালো স্ট্যান্ড স্যামসং টিভি
Neon green time and date stamp##person	নিয়ন সবুজ সময় এবং তারিখ স্ট্যাম্প
the blue handle of a french press##cup,dining table,chair,sandwich,sandwich,dining table,cup	একটি ফরাসি প্রেসের নীল হাতল
an alarm clock on the night stand##tv,bed,chair,potted plant,dining table,chair,bed,oven,dining table,dining table	নাইট স্ট্যান্ডে একটি অ্যালার্ম ঘড়ি
Dark colored stand a tv is on.##tv,chair,bottle,chair,bed,chair,chair,bottle,chair,bottle	গাঢ় রঙিন স্ট্যান্ড একটি টিভি চালু আছে।
second traffic light on pole##bicycle,traffic light,traffic light,traffic light,traffic light,traffic light,traffic light,traffic light,car,traffic light	স্ট্যান্ডে দ্বিতীয় ট্র্যাফিক আলো 
Old english writing on board##person,surfboard	বোর্ডে পুরানো ইংরেজি লেখা
this is a coffee press##person,bottle,bowl,sink,knife,knife,bottle,spoon,cup,bottle	এটি একটি কফি প্রেস
Green grass forms the ground.##kite,kite,kite,kite,person,kite,person,person,person,person	সবুজ ঘাস মাটি গঠন করে।
sign laying on the second set of red apples##apple,apple,apple,person,apple,apple,apple,apple,apple,apple	লাল আপেল এর দ্বিতীয় সেট এর উপর সাইন পড়ে আছে 
A sign in not english##person,person,person,person,person,handbag,orange,person,person,orange	ইংরাজিতে নয় এমন একটি সাইন
black remote on the tv stand##tv,remote,remote,person,person,person,book,keyboard,book,person	টিভি স্ট্যান্ড কালো রিমোট
Windows logo stamp on laptop.##laptop,bottle,cell phone,bottle,mouse,book,cell phone,book,book,book	ল্যাপটপে উইন্ডোজ লোগো স্ট্যাম্প।
french press coffee maker on the table##laptop,person,person,laptop,potted plant,person,vase,chair,cup,couch	টেবিলে ফ্রেঞ্চ প্রেস কফি প্রস্তুতকারক 
Black stand with microphone##person,tie,book,tie	মাইক্রোফোন দিয়ে কালো স্ট্যান্ড
little white english car with vertical oblong taillights##bus,traffic light,traffic light,bus,bus,person,person,person,person,car	উল্লম্ব বিভাজন টেইলাইট সহ ছোট সাদা ইংলিশ গাড়ি
aqua press wall with white advertising signs##person,person,person,person,banana,banana,person,person,banana,banana	সাদা বিজ্ঞাপনের লক্ষণ সহ একোয়া প্রেস ওয়াল
Soccer players on field.##person,sports ball,person,person,sports ball,sports ball,person,sports ball,person,person	মাঠে সকার খেলোয়াড়রা।
Top of net on tennis court##person,tennis racket	টেনিস কোর্টে নেট শীর্ষ
Coming fast around the bend##motorcycle,person,person	বাঁক এর পাশে দ্রুতগতিতে আসছে 
Blue border around tennis court##person,baseball bat,sports ball,backpack,chair	টেনিস কোর্টের চারপাশে নীল সীমানা
ink stamp print##person,tie,person,person,person,person,tie,person,person,person	কালি স্ট্যাম্প প্রিন্ট
yellow sticker with asian characters##car,car,car,truck,truck,car,car,traffic light,traffic light,truck	এশিয়ান অক্ষরের সাথে হলুদ স্টিকার
second seat on motorcycle##motorcycle,person,car	মোটরসাইকেলের দ্বিতীয় আসন
four female soccer players on a grassy field##person,person,person,sports ball,person,person,car	ঘাসের মাঠে চারজন মহিলা ফুটবল খেলোয়াড়
date 2008 printed on the label##bottle,wine glass,person,bottle,person,dining table,person	তারিখ 2008 লেবেলে মুদ্রিত
grass tennis court##person,tennis racket,person,chair,person,person,person,person,person,person	গ্রাস টেনিস কোর্ট
colored springs on truck##truck,truck,person,truck,truck,truck,truck,person,truck,person	ট্রাকে রঙিন স্প্রিং
white cement block wall##toilet,skateboard	সাদা সিমেন্ট ব্লক প্রাচীর
a cats closed eye forms a slit##cat,couch	একটি বিড়াল বদ্ধ চোখ একটি চেরা গঠন
the judge's chair by the court##person,person,person,tennis racket,person,person,person,person,person,person	কোর্ট এর পাশে বিচারক এর চেয়ার
a white surfboard stand next to yellow one##surfboard,surfboard,surfboard,surfboard,surfboard,surfboard,skateboard,skateboard	হলুদ রঙের পাশে একটি সাদা সার্ফবোর্ড
a layer of fine sweet chocolate##donut,donut,donut,donut,donut,donut,person,donut,donut	সূক্ষ্ম মিষ্টি চকোলেট একটি স্তর
the watermark is a block font##traffic light,clock	ওয়াটারমার্ক একটি ব্লক ফন্ট
red second hand on top of other hands##clock,horse,horse	অন্য কাঁটার উপর লাল সেকেন্ডের কাঁটা
long fine hairs on chin##horse,bear	চিবুকের উপর দীর্ঘ সূক্ষ্ম চুল
Single white line drawn on tennis court##person,tennis racket	টেনিস কোর্টে টানা একক সাদা লাইন
a red cross decal##airplane,person,airplane	একটি রেড ক্রস ডেসাল
Blue garbage can on second floor.##person,person,person,person,cell phone,cup	নীল আবর্জনা দ্বিতীয় তলায় করতে পারেন।
front of military plane is pointed and fast##airplane	সামরিক বিমানের সামনে পয়েন্ট এবং দ্রুত হয়
signature of artist and date##horse,horse,banana,cow,bird,horse	শিল্পীর স্বাক্ষর এবং তারিখ
book of forms on desk##pizza,knife,pizza,pizza,pizza,pizza,person,pizza,pizza,pizza	ডেস্কে ফর্ম বই
Silver french press coffee maker##cup,cup,chair,umbrella,chair,dining table,umbrella,spoon,chair,spoon	সিলভার ফরাসি প্রেস কফি প্রস্তুতকারক
orange date stamp on photo##giraffe	ছবির উপর কমলা তারিখ স্ট্যাম্প
woman in back of a court##person,tennis racket,person,bicycle	কোর্টের পিছনে মহিলা
the date of the picture##person,dining table,tie,bottle,book,sports ball	ছবির তারিখ
gray color on court##person,person,person,person,tennis racket,tennis racket,tennis racket,tennis racket,car,car	কোর্টে ধূসর রঙ
small models boats on TV##tv,cup,potted plant,vase,person,skateboard,book,bowl,vase,book	ছোট মডেল টিভিতে নৌকা
glass block privacy wall##chair,cup,tv,book,mouse,dining table,book,dining table,dining table,dining table	কাচ ব্লক গোপনীয়তা প্রাচীর
red painted lines on wooden court floor##person,person,tennis racket,tennis racket	কাঠের কোর্ট ফ্লোরে লাল আঁকা লাইন
red cross with a white background##clock,clock	একটি সাদা পটভূমি সঙ্গে রেড ক্রস
soccer players in a light blue uniforms##person,person,person,person,person,person,sports ball,person,person,person	হালকা নীল রঙের ইউনিফর্মে ফুটবল খেলোয়াড়
car moving incredibly fast##car,car,motorcycle	অবিশ্বাস্যভাবে দ্রুত গাড়ী চলমান
a small dark brown night stand##bed,chair,book,dining table,laptop,book	একটি ছোট গাঢ় বাদামী নাইট স্ট্যান্ড
a sign in a language that isn't English##	ইংরাজী নয় এমন একটি ভাষায় সাইন
silver and black French press coffee pot##cup,cup,cup,cup,bowl,dining table,chair,cup,cup,cup	সিলভার এবং কালো ফরাসি প্রেস কফি পাত্র
green bench on court##person,person,chair,tennis racket,person,sports ball,person,chair,cup,bench	কোর্টে সবুজ বেঞ্চ
pendent on a fine chain##person,person,cake,person,cake,dining table,cake,chair,person	একটি সূক্ষ্ম চেইন উপর দুল
Paper forms on the table.##banana,sandwich,dining table	টেবিলে কাগজের ফর্মগুলি।
A ball girl at the back of a tennis court##person,person,person,person,chair,tennis racket,tennis racket,chair,person,person	টেনিস কোর্টের পিছনে একটি বালিকা
Thick white wooden cross.##person,car,cell phone,bus,truck,car	ঘন সাদা কাঠের ক্রস।
the second cushioned seat##chair,chair,chair,book,bench,book,book,book,book,book	দ্বিতীয় কুশনযুক্ত আসন
A black barrier stand.##person,person,tv,person,person,person,person,cell phone,person	একটি কালো বাধা স্ট্যান্ড।
green surface surrounding tennis court##person,tennis racket,person	টেনিস কোর্টের চারপাশে সবুজ পৃষ্ঠ
Silhouette of tennis player on court.##person,person,person,chair,tennis racket,tennis racket,person,sports ball,tennis racket	কোর্টে টেনিস খেলোয়াড়ের সিলুয়েট।
black electric clock on night stand##vase,bed,bed,couch,couch,cell phone,cell phone,bowl	নাইট স্ট্যান্ডে কালো বৈদ্যুতিন ঘড়ি
a skate boarder going fast##person,skateboard,person,person,person,person,train,person,person	একজন স্কেট বোর্ডার দ্রুত যাচ্ছেন
5 cars of varying models parked on the street##stop sign,car,car,car,car,car,car,car,truck	রাস্তায় পার্কিং বিভিন্ন মডেলের 5 টি গাড়ি
Signs on signpost naming streets and block numbers##	সাইনপোস্ট নামকরণ রাস্তায় এবং ব্লক নম্বরগুলিতে চিহ্ন
big hairy fair laps##person,refrigerator,bottle,bottle,banana	বড় লোমশ ফর্সা কোল
white edge of white tennis court##person,person,tennis racket,sports ball,sports ball,tennis racket	সাদা টেনিস কোর্ট সাদা প্রান্ত
name and date in the corner##person,umbrella,person,person,boat,umbrella,person,person	কোণে নাম এবং তারিখ
yellowish green grass over fine tan sand##horse,horse,horse	সূক্ষ্ম ট্যান বালির উপরে হলুদ সবুজ ঘাস
small child cross country skiing##person,skis	ছোট শিশু ক্রস কান্ট্রি স্কিইং
a net divides the court##person,person,person,person,tennis racket,tennis racket,bottle,sports ball,person,sports ball	একটি নেট কোর্ট বিভক্ত
walking so fast person is captured as a blur##person,person,person,person,car,car,umbrella,person,umbrella,traffic light	এত তাড়াতাড়ি হাঁটলে একজন মানুষকে ঝাপসা হয়ে যায়
the knife block is filled##oven,refrigerator,microwave,cup,spoon,spoon	ছুরির ব্লকটি ভরে গেছে
Long forks and springs##person,person,truck,person,car,motorcycle,truck,truck,chair	দীর্ঘ কাঁটাচামচ এবং ঝর্ণা
baseball players dressed in red and gray##person,person,person,person,baseball bat,person,person,person,chair,person	বেসবল খেলোয়াড়রা লাল এবং ধূসর পোশাকে
second paper notice in a row##tv,suitcase	পরপর দ্বিতীয় কাগজ নোটিশ
second story seating area##bus,dining table,dining table,chair,chair,chair,chair,chair,person,dining table	দ্বিতীয় গল্পের বসার জায়গা
a cross country skier bending low##person,person,person,person,person,person,person,skis,skis,skis	কম ক্রস কান্ট্রি স্কাইয়ার
Shadow running across a tennis court##person,tennis racket	টেনিস কোর্ট জুড়ে ছায়া চলছে
Coolers in front of the players.##person,person,person,baseball bat,person,person,baseball glove,person,sports ball,person	খেলোয়াড়দের সামনে কুলার।
Cartoon characters on top of the building.##car,donut,person,person,person,cake,car,person,person,person	বিল্ডিংয়ের উপরে কার্টুন চরিত্রগুলি।
black lamp with floor stand##laptop,tv,keyboard,mouse,chair,keyboard,spoon,person	মেঝে স্ট্যান্ড সহ কালো বাতি
Security officer making sure everyone is safe at the fair##person,person,bottle,person,person,person,person,person,person,person	সুরক্ষার আধিকারিক নিশ্চিত করছেন মেলায় সবাই নিরাপদে আছেন
the springs are silver##motorcycle,person,handbag,person,person,person,person,handbag,truck,person	ঝর্ণা রূপা হয়
sticker is blue+white and i think written in English+kanji##teddy bear,skis,kite	স্টিকারটি নীল + সাদা এবং আমার মনে হয় ইংরেজিতে + কঞ্জি লেখা আছে
a white sign not in English##person,boat,boat,boat,boat,potted plant,person,boat,boat,boat	একটি সাদা চিহ্ন ইংরাজীতে নয়
man working at stand##person,person,person,person,person,person,person,bus,umbrella,motorcycle	লোক স্ট্যান্ড এ কাজ
man standing in a tennis court##person,bench,car,car,tennis racket,bench,sports ball,person,traffic light	টেনিস কোর্টে দাঁড়িয়ে লোক
black band on players wrist##person,tennis racket,sports ball,person	খেলোয়াড়ের কব্জিতে কালো ব্যান্ড
Name and date on the bottom right corner.##motorcycle,car,motorcycle,car,person,motorcycle,motorcycle,car,motorcycle,person	নীচে ডান কোণে নাম এবং তারিখ।
red second hand##clock	লাল দ্বিতীয় হাত
orange line on court##person,sports ball,person,bench,person,bench	কোর্টে কমলা রেখা
date on the screen##cell phone,mouse,person,person	পর্দায় তারিখ
Baseball cap to block sun##person,sports ball,baseball bat,bench	বেসবল ক্যাপ রোদে ব্লক
a missing cider block opening to the outside##toilet,boat	বাইরে থেকে একটি অনুপস্থিত সাইডার ব্লক
a cross on the top of the church##clock,traffic light,traffic light,car,traffic light,potted plant,car,traffic light,traffic light,traffic light	গির্জার উপরে একটি ক্রস
green grass by tennis court##person,person,tennis racket,tennis racket,bench,person,person	টেনিস কোর্ট দ্বারা সবুজ ঘাস
Some traffic is moving very fast##person,motorcycle,car	কিছু ট্র্যাফিক খুব দ্রুত চলছে
Large blue flag above the entire fair##horse,horse,horse,horse,horse,person,horse,person,horse,person	পুরো মেলার উপরে বড় বড় নীল পতাকা
A crack on the court##person,person,person,person,person,tennis racket,tennis racket,person,tennis racket,tennis racket	কোর্টে একটি ফাটল
The tennis players arm extended.##person,tennis racket,sports ball,potted plant,chair,chair,person	টেনিস খেলোয়াড়দের হাত বাড়ানো।
concrete block near street.##truck,car,car,person	রাস্তার কাছে কংক্রিট ব্লক
Number of court on the wall.##person,tennis racket,tennis racket	দেয়ালে কোর্টের সংখ্যা।
wooden sign with white letters on second bus##person,bus,person,person,person,person,person,person,person,person	দ্বিতীয় বাসে সাদা বর্ণের সাথে কাঠের চিহ্ন
exte stamp on yellow metal##train,train,person,bus,person,boat	হলুদ ধাতু উপর স্ট্যাম্প exte
tree root jutting out in jagged forms##bear	ঝাঁকুনিযুক্ত ফর্মগুলিতে গাছের শিকড় কাটছে
microphones are lined up on stand##person,person,person,person,person,person,tie,tie,person,person	মাইক্রোফোনগুলি স্ট্যান্ডে রেখাযুক্ত থাকে
the white cross on the flag##person,tennis racket,person,person,tennis racket	পতাকা সাদা ক্রস
the yellow block in the parking stall##person,person,person,cup,bottle,cell phone,bottle,dining table,cup,baseball bat	পার্কিং স্টলে হলুদ ব্লক
a sign that forms an X##traffic light,traffic light,traffic light,traffic light,traffic light,traffic light,traffic light,traffic light,traffic light,traffic light	এমন একটি চিহ্ন যা একটি এক্স গঠন করে
Land forms in the distance##person,person,skis	দূরত্বে জমি ফর্ম
playing on green and blue court##person,tennis racket,sports ball	সবুজ এবং নীল কোর্টে বাজানো
the sport is cross country##person,person,skis,skis	খেলাটি ক্রস কান্ট্রি
this wall forms a stall##sink,toilet	এই প্রাচীর একটি স্টল গঠন
A metal and stone column holding a bell and cross.##clock	একটি ধাতু এবং পাথর কলাম একটি ঘন্টা এবং ক্রস ধারণ করে।
a tea set on a wooden stand##person,cup,vase,chair,cup,dining table,cup,bowl,cake,cup	একটি কাঠের স্ট্যান্ডে একটি চা সেট
this is a press conference##person,person,tie,person,car,car,tie,person,person,car	এটি একটি সংবাদ সম্মেলন
second airplane leaves smoke trail##airplane,airplane,airplane,airplane	দ্বিতীয় বিমান ধোঁয়া ট্রেল ছেড়ে
white characters on the street##person,person,stop sign,bicycle,potted plant,potted plant,bench,parking meter	রাস্তায় সাদা অক্ষর
people eating fast food##person,person,person,person,chair,person,person,chair,person,person	লোকেরা ফাস্টফুড খাচ্ছে
date in the corner##person,person,kite,kite,kite	কোণে তারিখ
Silver cross necklace##person,tennis racket	সিলভার ক্রস নেকলেস
block of snow on a hill##person,person,person,person,person,skis,person,skis,skis,kite	একটি পাহাড়ে তুষার ব্লক
a red and white county fair tent##person,skateboard,person,person,person,person,person,person,person,person	একটি লাল এবং সাদা কাউন্টি ফর্সা তাঁবু
long fine whiskers on a cat##cat,fork	একটি বিড়াল উপর দীর্ঘ সূক্ষ্ম ফিসফিসার
man in a white hat on the tennis court##person,tennis racket,person,sports ball,sports ball,sports ball,sports ball,sports ball,sports ball	টেনিস কোর্টে একটি সাদা টুপি লোক
a man in a yellow t-shirt sitting cross-legged##person,person,person,person,person,umbrella,person,person,person,person	হলুদ টি-শার্টের এক লোক ক্রস লেগে বসে আছে
long single block in row##banana	সারিবদ্ধ দীর্ঘ একক ব্লক
Two fine drinking glasses##person,wine glass,person,person,wine glass,wine glass,person,wine glass,wine glass,bottle	দুটো সূক্ষ্ম মদ্যপান
green baseball field with players on it##person,person,person,baseball bat,baseball bat,cell phone,cell phone,person	গ্রিন বেসবল মাঠে এটি খেলোয়াড়দের সাথে
Man stand in crane##traffic light,traffic light,truck,truck,car,car,car,car,car,car	মানুষ ক্রেনে দাঁড়িয়ে আছে
The characters 9F on the side of a plane##airplane	একটি বিমানের পাশে 9F অক্ষর
English city bus on the road##bus	রাস্তায় ইংলিশ সিটি বাস
the date is probably somehow, somewhat primitively digitally conveyed##clock,potted plant	তারিখটি সম্ভবত একরকম, কিছুটা প্রাথমিকভাবে ডিজিটালভাবে জানানো হয়েছে
blue plastic hot dog stand##fork,bottle,cup,cup,knife,dining table,hot dog,fork,cake,pizza	নীল প্লাস্টিকের হট ডগ স্ট্যান্ড
A dirty white dish towel with red cross stripes##oven,laptop,bottle,refrigerator,cup,bottle	রেড ক্রস স্ট্রাইপযুক্ত একটি নোংরা সাদা ডিশ তোয়ালে
Two baseball players talking to each other##person,person,person,person,person,sports ball,baseball bat,baseball bat,chair,chair	দুই বেসবল খেলোয়াড় একে অপরের সাথে কথা বলছে
long net across the court##person,person,sports ball,person,person,person,tennis racket	কোর্ট জুড়ে দীর্ঘ নেট
a person cross country skiing in the background##person,person,person,skis,person,person,person,skis,person,car	একজন ব্যক্তি পটভূমিতে দেশ স্কিইং ক্রস করে
baseball players on field##person,person,person,person,sports ball,baseball glove,person,person,baseball glove,baseball glove	মাঠে বেসবল খেলোয়াড়
Yellow and black pole with a yellow cross.##train,person,train,traffic light,traffic light,traffic light,traffic light,train,train,train	একটি হলুদ ক্রস সহ হলুদ এবং কালো পোল।
A white box with a red cross.##toilet,sink,hair drier,cup	একটি লাল ক্রসযুক্ত একটি সাদা বাক্স।
Bread dough cross hatched design##oven,person,person,knife	রুটি ময়দার ক্রস হ্যাচড ডিজাইন
White boundary lines on the tennis court.##person,tennis racket	টেনিস কোর্টে সাদা সীমানা লাইন।
waves forms behind the boat##boat,person,person,person,person,person	তরঙ্গ নৌকা পিছনে ফর্ম
second floor balcony##car	দ্বিতীয় তল বারান্দা
fast food hot dogs and onion rings##person,hot dog,hot dog,cup,donut,dining table,donut,bowl	ফাস্ট ফুড হট কুকুর এবং পেঁয়াজ রিং
Time date stamp is bottom right##airplane,airplane,boat,airplane,boat	সময় তারিখ স্ট্যাম্প নীচে ডান
12/22/2006 date stamp##person,book,book,book,book,book,book,chair,book,book	12/22/2006 তারিখ স্ট্যাম্প
fine grey gravel under players' legs##person,frisbee,person	খেলোয়াড়দের পায়ের নীচে জরিমানা ধূসর কঙ্কর
lamp stand light##bed,book,clock,book	বাতি স্ট্যান্ড আলো
a professional tennis court##person,tennis racket,sports ball	একটি পেশাদার টেনিস কোর্ট
Tall date palm##clock	লম্বা খেজুর
Dresser with dinosaur models on top##bed,potted plant,couch,clock	শীর্ষে ডাইনোসর মডেল সহ ড্র্রেসার
top of tennis court##tennis racket,person,person,tennis racket,chair	টেনিস কোর্ট শীর্ষ
Woman dressed as a maiden at the fair##person,person,horse,horse,person,person,person,person,person,person	মেলায় প্রথম মেয়েটির পোশাক পরা মহিলা
characters apart on stage set##tv,person,remote,person,person,person,person,handbag,book,person	মঞ্চে সেট অক্ষর পৃথক
Chinese characters on the back of the truck##car,truck,car,motorcycle,car,bus,person,car,traffic light,traffic light	ট্রাকের পেছনে চীনা অক্ষর
fast blue and white train##person,train,tv,suitcase,handbag,person,person,car	দ্রুত নীল এবং সাদা ট্রেন
players name on his shirt##person,person,person,baseball glove,person,person,baseball bat,baseball bat,person	তার শার্টে খেলোয়াড়দের নাম
College baseball players on the field.##person,person,person,person,baseball glove,person,person,person,person,person	মাঠে কলেজ বেসবল খেলোয়াড়।
blue court on the ground##person,sports ball,tennis racket	মাটিতে নীল কোর্ট
Two toasted English muffins on a plate.##bottle,cup,dining table,person,person,cup,cup,refrigerator,person,cup	একটি প্লেটে দুটি টোস্টেড ইংলিশ মাফিনস।
Bag on the cement block##bottle,sink	সিমেন্ট ব্লকে ব্যাগ
flower on ice block##teddy bear,oven,person,train	আইস ব্লকে ফুল
yellow tennis balls on court##person,tennis racket,sports ball,sports ball,sports ball,sports ball,sports ball,sports ball	কোর্টে হলুদ টেনিস বল
A person waiting to cross the street##person,traffic light,traffic light,person,traffic light,car,car,potted plant,car,car	রাস্তা পার হওয়ার অপেক্ষায় থাকা এক ব্যক্তি
tan colored brick block wall##traffic light,person,person	ট্যান রঙিন ইট ব্লক প্রাচীর
A dark wooden cross with a small sign attached##stop sign,person,skateboard,dining table	একটি গাঢ় কাঠের ক্রস যার সাথে একটি ছোট চিহ্ন যুক্ত রয়েছে
A clock with cartoon characters on##person,person,person,person,clock,book,bird,book,book,book	কার্টুন চরিত্রগুলি সহ একটি ঘড়ি
rocky and rectangular block with openings on dirt##giraffe,giraffe,giraffe	ময়লা উপর খোলার সঙ্গে পাথুরে এবং আয়তক্ষেত্রাকার ব্লক
adult on a tennis court##person,person,person,tennis racket,person,person,tennis racket,person,person,person	টেনিস কোর্টে প্রাপ্তবয়স্ক
Knives in a wooden block on the countertop.##refrigerator,oven,bowl,dining table,knife,orange,fork,knife,knife,knife	কাউন্টারটপের একটি কাঠের ব্লকে ছুরিগুলি।
leg of the second person##person,bird,bird	দ্বিতীয় ব্যক্তির পা
awning for food stand##cup,person,person,umbrella,person,person,person,person,person,person	খাদ্য স্ট্যান্ড জন্য সজাগ
Knives in a wooden block behind the stove.##oven,knife,bottle,bottle,bottle,knife,bottle,bottle,microwave,knife	চুলার পিছনে কাঠের ব্লকে ছুরি।
a red newspaper stand##car,car,car,traffic light,car,car,car	একটি লাল সংবাদপত্র স্ট্যান্ড
Brown block and white house with pitched black roof.##bus,person,person,person,person,bus,person,person	কালো ছাদযুক্ত ব্রাউন ব্লক এবং সাদা ঘর।
The train is traveling in fair weather##train,person,person,traffic light,train,traffic light,traffic light,person,person	ট্রেনটি ন্যায্য আবহাওয়ায় ভ্রমণ করছে
fast food on white plate##cup,hot dog,oven,dining table	সাদা প্লেটে ফাস্টফুড
air forces flag##airplane,truck,airplane	বিমান বাহিনী পতাকা
some watery plant forms##elephant,person,person,person,bench	কিছু জলযুক্ত উদ্ভিদ ফর্ম
curves of forms worn over shoes on snowboard##person,person,snowboard,snowboard,skis,skis,snowboard,bicycle,skis	স্নোবোর্ডে জুতো পরে ফর্মের বক্ররেখা
woman sitting on a stone block##person,suitcase,person,person,person,suitcase,bench,remote,person	পাথরের ব্লকে বসে মহিলা 
black lamb second from right##person,sheep,person,tie,sheep,sheep,dog,sheep,dog,dog	ডান থেকে দ্বিতীয় মেষশাবক
blue wall of the court##person,tennis racket	কোর্টের নীল প্রাচীর
a wood night stand.##bed,bed	একটি কাঠ নাইট স্ট্যান্ড
the wall is cement block##train,person	প্রাচীর সিমেন্ট ব্লক
the court is dark blue##person,tennis racket,person,person,person,person,person	কোর্ট গাঢ় নীল
The man's black shadow on the court##person,person,tennis racket,tennis racket,person,person,sports ball,person,person,person	কোর্টে লোকটির কালো ছায়া
Woman standing on tennis court##person,tennis racket	টেনিস কোর্টে দাঁড়িয়ে মহিলা
a music stand on a curb##stop sign,person,person,car,person,person	একটি সংকোচনের উপর একটি সঙ্গীত স্ট্যান্ড
a weed growing up from the tennis court##person,sports ball,tennis racket,car	টেনিস কোর্ট থেকে আগাছা বাড়ছে
The military plane has a cross on the tail.##airplane	সামরিক বিমানের লেজটিতে একটি ক্রস রয়েছে।
small food press on stove##donut,oven,pizza,donut,oven,cake,hot dog	চুলায় ছোট খাবার প্রেস
two bicyclists waiting to cross intersection##bicycle,traffic light,traffic light,person,traffic light,traffic light,car,traffic light,person,person	চৌরাস্তা পার হওয়ার অপেক্ষায় দুজন সাইকেল চালক
cross nailed to a wall##person,person,tie,teddy bear,tie	ক্রস একটি প্রাচীরে গাঁথা
Wooden butcher block on kitchen sink.##oven,oven,sink,oven,oven,oven,bench	রান্নাঘরের বেসিন এর উপর কাঠের বুচার ব্লক
three black Japanese characters##airplane	তিনটি কালো জাপানি অক্ষর
microphone on angled stand##person,person,person,person,person,person,person,person,tie,person	কোণযুক্ত স্ট্যান্ডে মাইক্রোফোন
Look of concentration on game players face##person,person,remote,remote,remote,remote,couch,couch,chair,chair	গেম খেলোয়াড়দের মুখের প্রতি একাগ্রতার চেহারা
blue cross on front of car##teddy bear,person,teddy bear,car,teddy bear,teddy bear,bicycle	গাড়ির সামনে নীল ক্রস
the blue painted do not cross line on the train platform##train,train,person,person,person,person,person	নীল রঙে আঁকা ট্রেনের প্ল্যাটফর্মে লাইনটি অতিক্রম করে না
tennis match in progress on outdoor court##person,person,tennis racket	আউটডোর কোর্টে টেনিস ম্যাচ চলছে
Two men on a tennis court playing tennis##person,person,tennis racket,tennis racket,tennis racket,sports ball	টেনিস খেলতে টেনিস কোর্টে দুজন লোক
wood block of knives##bottle,wine glass,knife,knife,vase,microwave,wine glass,knife,person,remote	ছুরির কাঠের ব্লক
A block of brown stones.##person,car,car,car,car,car,car,car,car,car	বাদামী পাথর একটি ব্লক।
players' names in black on yellow background##person,person,sports ball,person,tennis racket,chair,tennis racket	হলুদ পটভূমিতে কালো রঙের প্লেয়ারদের নাম
an off white set of box springs##person,bed,teddy bear,bottle,chair	বক্স স্প্রিংস একটি সাদা সাদা সেট
Blue characters on a white background##laptop,book,book,cell phone,book,dining table	একটি সাদা পটভূমিতে নীল অক্ষর
TV on the stand.##person,person,chair,book,book,book,book,bottle,book,book	স্ট্যান্ডে টিভি।
Yellow ball on the court.##person,person,person,person,person,person,tennis racket,sports ball,tennis racket,tennis racket	কোর্টে হলুদ বল।
Electrical wire stand##traffic light,traffic light,traffic light,stop sign,traffic light,traffic light,kite	বৈদ্যুতিক তারের স্ট্যান্ড
cross made of stone##person,person,person,bird,dining table,person,person,person,person,bird	পাথরের তৈরি ক্রস
The traffic light has a red cross.##person,traffic light,train,person,person,person,person,person,person,person	ট্র্যাফিক লাইটের একটি রেড ক্রস রয়েছে।
ball on a tennis court##person,sports ball,tennis racket,sports ball,sports ball,sports ball,sports ball,sports ball,sports ball	টেনিস কোর্টে বল
cross walk area painted on the street##traffic light,car,fire hydrant,traffic light	রাস্তায় আঁকা ক্রস ওয়াক এরিয়া
Brown stand holding bananas.##banana,banana,banana,banana,banana,banana,banana,banana,banana,banana	কলা বাদামী স্ট্যান্ড।
the line that shows foul or fair##person,person,baseball bat,baseball glove,person,person,person,person,person,person	লাইনটি অশ্লীল বা ফর্সা দেখায়
Knob above knife block##person,oven,cup,tie,microwave,dining table,oven,knife,bowl,oven	ছুরি ব্লক উপরে গিঁট
A time stamp on a video.##person,backpack,cell phone,backpack,bench,handbag,bench,potted plant	একটি ভিডিওতে টাইম স্ট্যাম্প।
a clock on a glass stand##person,person,person,person,clock,person,person,person,person,person	কাচের স্ট্যান্ডের একটি ঘড়ি
One person on the court##person,tennis racket,chair,person,person,person,person,person,person,person	কোর্টে একজন ব্যক্তি
Road block submerged by water##	জলে নিমজ্জিত রোড ব্লক
tennis court floor is blue##person,tennis racket,person,person	টেনিস কোর্ট ফ্লোর নীল
baseball players signing autographs##person,person,person,baseball glove,baseball glove,cell phone,person,potted plant,cell phone,person	বেসবল খেলোয়াড় অটোগ্রাফ স্বাক্ষর
fine metal safety netting##person,person,person,person,bench,baseball glove,person,person,baseball glove,person	সূক্ষ্ম ধাতু সুরক্ষা জাল
An audience witnessing a press conference##person,person,tv,person,tv,tv,person,laptop,person,tv	এক সংবাদ সম্মেলনের সাক্ষী শ্রোতা
players in team dugout##person,person,person,baseball bat,baseball glove,person,chair,chair,person,person	টীম ডাগআউট এ খেলোয়াড়রা
white frisbee in players hands##frisbee,person,person,person,person,umbrella	খেলোয়াড়দের হাতে সাদা ফ্রিসবি
time and date stamp##car,car,car,car,truck,car,car,truck,truck	সময় এবং তারিখ স্ট্যাম্প
A TV stand##tv,couch,chair,vase,bench,book,book,book,book,potted plant	একটি টিভি স্ট্যান্ড
The time stamp display window on the meter on the left.##parking meter,parking meter,person,person	বামদিকে মিটারে সময় স্ট্যাম্প প্রদর্শন উইন্ডো।
a wooden block of knives##knife,knife,knife,knife,knife,bowl,bowl,spoon,bowl,knife	ছুরি একটি কাঠের ব্লক
a second story railing##truck,chair,person	একটি দ্বিতীয় গল্প রেলিং
This is a picture of Chinese characters##person,person,person	এটি চাইনিজ চরিত্রগুলির একটি ছবি
fast super jet hovers in the sky##airplane	দ্রুত সুপার জেট আকাশে ঘোরাফেরা করে
the players are moving##person,person,person,person,person,person,baseball glove,backpack,sports ball,baseball glove	খেলোয়াড়রা চলাফেরা করছে
two guys in the background are observing the movements of the players##person,person,person,person,person,person,person,person,person,person	পটভূমির দু'জন খেলোয়াড় খেলোয়াড়দের চলন পর্যবেক্ষণ করছে 
Curled metal legs on a candle stand##person,person,bed,person,bowl	একটি মোমবাতি স্ট্যান্ডের উপর কার্ল ধাতব পা
two players watching the batter##person,person,person,baseball glove,person,person,person,baseball bat,person,person	দুই খেলোয়াড় ব্যাটার দেখছেন
fine white spray against nose of craft##boat,surfboard	নৈপুণ্যের নাকের বিরুদ্ধে সূক্ষ্ম সাদা স্প্রে
Brown tennis court floor##person,person,tennis racket,chair,chair,person,person,sports ball,person,person	ব্রাউন টেনিস কোর্ট ফ্লোর
cross on top of church##person,bench,bench,person,chair,car	গির্জার উপরে ক্রস
copyright and date##bench,bench,bench,bench,bench	কপিরাইট এবং তারিখ
A sign for the 550 west block of Bliss Ct.##	ব্লিস সিটি-এর 550 পশ্চিম ব্লকের জন্য একটি চিহ্ন।
Opponent Reaching Out to block##person,person,frisbee,person,person,person,person,person,person,person	প্রতিপক্ষ ব্লক করতে পৌঁছেছে
Laptop on a stand##keyboard,laptop,mouse,cup,cup,person,tv,chair,person,tv	একটি স্ট্যান্ডে ল্যাপটপ
a wooden block sitting on the table##person,person,dining table,vase,bowl,book,bottle	টেবিলের উপর বসে একটি কাঠের ব্লক
Part of the tennis court is green.##person,tennis racket,sports ball	টেনিস কোর্টের কিছু অংশ সবুজ।
two players in orange and white sitting on sidelines##person,person,person,person,person,person,person,person,person,person	কমলা এবং সাদা দুই খেলোয়াড় সাইড লাইনে বসে on
date stamp of photo##cat,bowl,bowl,refrigerator	ছবির তারিখ স্ট্যাম্প
a pole of a lamp stand##potted plant,clock	একটি বাতি স্ট্যান্ডের একটি খুঁটি
the door of second floor is brown##car,car,car,car,motorcycle,motorcycle,car,car,car,car	দ্বিতীয় তলার দরজাটি বাদামী
Front wheel on second white truck.##stop sign,truck,car,potted plant	দ্বিতীয় সাদা ট্রাকে সম্মুখ চাকা।
the second gold horse##horse,horse,horse,horse,umbrella,person,person,person	দ্বিতীয় সোনার ঘোড়া
A small grey block on the median##clock,clock,bench,potted plant,fire hydrant	মিডিয়ানের উপর একটি ছোট ধূসর ব্লক
Woman on a tennis court##person,tennis racket,sports ball	টেনিস কোর্টে মহিলা
red characters on top of blue building##	নীল ভবনের উপরে লাল অক্ষর
the collar decoration of a fair isle type sweater##person,person,person,cake,dining table,chair,dining table,chair,person,cup	ফেয়ার আইল টাইপের সোয়েটারের কলার সজ্জা
Woman wearing a cross on her neck##person,person,person,person,wine glass,wine glass,wine glass,person,wine glass,chair	গলায় ক্রস পরা মহিলা
a colorful display lighted characters##clock,car,person,person,horse,person,person,person	একটি বর্ণময় প্রদর্শন আলোকিত অক্ষর
The second train car##train,train	দ্বিতীয় ট্রেনের গাড়ি
the players arm is ready to throw##person,baseball glove	খেলোয়াড়দের হাত ছুঁড়ে ফেলার জন্য প্রস্তুত
date and time stamp in corner##donut,donut,donut,dining table,donut,cake	কোণে তারিখ এবং সময় স্ট্যাম্প
Two characters on the television##tv,chair,mouse,remote,person,chair,person,dining table,clock,keyboard	টেলিভিশনে দুটি চরিত্র
blue net around tennis court##person,tennis racket	টেনিস কোর্ট কাছাকাছি নীল নেট
a block paved sidewalk##person,car,person,person,car,car,bicycle,person,bicycle,person	একটি ব্লক প্রশস্ত ফুটপাথ
a orange bottle in stand##toilet,bottle,sink,sink,chair,sink	স্ট্যান্ডে কমলা বোতল
The items of the second rack##refrigerator,bottle,bottle,bottle,bottle,bottle,bottle,bottle,refrigerator,bottle	দ্বিতীয় রাকের আইটেম
tan grey fine sand##person,surfboard,surfboard	ট্যান ধূসর সূক্ষ্ম বালি
fence in back of the court##person,tennis racket,apple	কোর্টের পিছনে বেড়া
five glass vases on the stand##chair,potted plant,cup,cup,vase,dining table,chair,cup,book,bowl	স্ট্যান্ডে পাঁচটি কাচের ফুলদানি
white Asian language characters painted on middle of street##person,person,bicycle,person,bicycle,bicycle,bicycle,person,bicycle,bicycle	রাস্তার মাঝখানে আঁকা সাদা এশিয়ান ভাষার অক্ষর
second leaf from left##vase,potted plant,dining table	বাম থেকে দ্বিতীয় পাতা
white fast logo in corner##person,snowboard	কোণে সাদা দ্রুত লোগো
a large concrete block##train,person	একটি বড় কংক্রিট ব্লক
a player on second base##person,person,person,person,baseball bat,person,person,person,person,baseball bat	দ্বিতীয় বেস একটি প্লেয়ার
fondant characters on cake##person,person,person,cake,cake,dog,cake,teddy bear,cake,cake	কেক উপর অনুরাগী চরিত্র
grey characters on a sign##	একটি চিহ্ন উপর ধূসর অক্ষর
Red tie with Peanuts characters##person,tie,cat,couch,couch	চিনাবাদামের অক্ষরগুলির সাথে লাল টাই
press here sticker on paw##teddy bear,teddy bear,teddy bear,teddy bear,teddy bear,teddy bear,teddy bear,teddy bear	পাঞ্জা এখানে স্টিকার প্রেস
a sign in a zoo, written in catalan - spanish – english##person,elephant,giraffe,horse,person,person	চিড়িয়াখানায় একটি চিহ্ন, নিখুঁত - স্প্যানিশ - ইংরেজি লেখা
White letters and numbers, indicating date and photographer.##airplane,airplane,truck,truck,truck,truck,truck,truck,car,truck	শ্বেত অক্ষর এবং সংখ্যা, ইঙ্গিত করে তারিখ এবং ফটোগ্রাফার।
window on second level##traffic light,traffic light,person,person,traffic light,person,person,person,person,traffic light	দ্বিতীয় স্তরের উইন্ডো
yellow date and time stamp##person,snowboard,snowboard,person,person,person	হলুদ তারিখ এবং সময় স্ট্যাম্প
players playing base ball on field##person,person,person,baseball glove,person,sports ball	খেলোয়াড়রা মাঠে বেস বল খেলছেন
a black fine tooth comb##knife,dining table	একটি কালো সূক্ষ্ম দাঁত চিরুনি
a second daybed in room##suitcase,bottle,couch,bottle,backpack,cup,couch,bed,chair	রুমে একটি দ্বিতীয় দিন
lots of kick+grab marks on white wall below blurry words of graffiti [likely not in english]##person,skateboard,person,bicycle,bicycle,person,bottle,bicycle,person	গ্রাফিতির অস্পষ্ট শব্দের নীচে সাদা দেয়ালে প্রচুর কিক + দখল চিহ্ন [সম্ভবত ইংরেজিতে নয়]
people enjoying themselves at the fair##person,person,donut,person,donut,person,person,donut,person,donut	মানুষ মেলায় নিজেকে উপভোগ করছে
bananas and oranges on fruit stand##orange,banana,banana,orange,banana,banana,orange,banana,banana,orange	কলা এবং কমলা ফলের স্ট্যান্ডে
A small food stand on wheels.##person,car,bus,car,person,car,car,car,person,person	চাকা উপর একটি ছোট খাবার স্ট্যান্ড।
fine china plate with gold rim##wine glass,dining table,bowl,carrot,carrot,carrot,carrot,carrot,carrot,carrot	সোনার রিম দিয়ে সূক্ষ্ম চীনার প্লেট
a white alarm clock is on top of the night stand##bed,clock,sink	নাইট স্ট্যান্ডের উপরে একটি সাদা অ্যালার্ম ঘড়ি রয়েছে
baseball players sitting in dugout##person,person,person,person,person,person,person,person,person,backpack	বেসবল খেলোয়াড় dugout বসে
letter on the wood block##scissors,suitcase,scissors,remote,suitcase	কাঠের ব্লকে চিঠি
Two butcher block knive sets.##person,dog,oven,bottle,bottle,bottle,bottle,microwave,bottle,bowl	দুটি কসাই ব্লক নাইভ সেট।
A sideways rendered date stamp##laptop,remote,tv,book,keyboard,book,suitcase	পার্শ্ববর্তী স্থানে তারিখের স্ট্যাম্প রেন্ডার করা
White second story porch##person,person,horse,horse,horse,horse,person,handbag	সাদা দ্বিতীয় গল্প বারান্দা
a door on the side of the court##person,sports ball,tennis racket,sports ball	দরজার পাশের একটি দরজা
a block defining the space for the bench##bench	বেঞ্চের জন্য স্থান নির্ধারণকারী একটি ব্লক
block of white text##person,baseball bat,person,person,handbag,person,person,tv	সাদা পাঠ্য ব্লক
a brown cat is stand##cat,laptop,person,couch,person	একটি বাদামী বিড়াল স্ট্যান্ড হয়
A train is going very fast##train,person,person,person	একটি ট্রেন খুব দ্রুত চলছে
Red and white Stop sign with characters in a non-English language##stop sign,stop sign,person,motorcycle,stop sign,stop sign,book	অ-ইংরাজী ভাষায় অক্ষরগুলির সাথে লাল এবং সাদা স্টপ সাইন
the shin guard on the players leg##person,sports ball,person,umbrella	খেলোয়াড়দের পায়ে শিন গার্ড
A tennis player standing in the court##person,person,person,person,person,person,person,person,person,tennis racket	একটি টেনিস খেলোয়াড় কোর্টে দাঁড়িয়ে
women waiting to cross##person,person,person,traffic light,traffic light,person,handbag,person,person,handbag	ক্রস করার অপেক্ষায় মহিলারা
blue tennis court with painted white boundary lines##person,sports ball,tennis racket,baseball glove	আঁকা সাদা সীমানা লাইন দিয়ে নীল টেনিস কোর্ট
white asphalt with fine lines##person,skateboard,bicycle,bicycle,potted plant,chair,bench,chair,bench	সূক্ষ্ম লাইনের সাথে সাদা ডামাল
date the photo was taken##teddy bear,cat	তারিখটি ছবি তোলা হয়েছিল
block of cheese on plate##oven,bottle,wine glass,refrigerator,pizza,dining table,spoon,chair	প্লেটে পনির ব্লক
They both are playing on a tennis court.##person,tennis racket,person,tennis racket	তারা দুজনেই টেনিস কোর্টে খেলছেন।
leaves on tennis court##person,tennis racket,sports ball	টেনিস কোর্ট ছেড়ে
a cross street sign##traffic light,parking meter	একটি ক্রস রাস্তার চিহ্ন
the net across their court##person,person,tennis racket,person,person,person,person,person,tennis racket,sports ball	তাদের কোর্ট জুড়ে নেট
geyer springs street sign##stop sign	জিয়ার স্প্রিংস রাস্তার চিহ্ন
couple guys walking on tennis court##person,tennis racket,person,person,person,person,person,person,sports ball,tennis racket	টেনিস কোর্টে হাঁটা দম্পতি
wooden cross hanging on a wall##bench,bench,chair,bench,bench,chair,chair,bench,bench,bench	একটি দেয়ালে ঝুলন্ত কাঠের ক্রস
cross structures for bridge support##airplane,airplane,kite	ব্রিজ সমর্থন জন্য ক্রস কাঠামো
boy standing on tennis court##person,person,tennis racket,tennis racket,car,car,tennis racket,handbag	টেনিস কোর্টে দাঁড়িয়ে ছেলে
Banana shaped yellow banana stand##person,person,person,person,person,person,cup,person,person,banana	কলা আকারের হলুদ কলা স্ট্যান্ড
A person below the date##clock,car,clock,car,person	তারিখের নীচে একজন ব্যক্তি
green tennis court with white lines##person,person,person,person,person,person,person,person,person,person	সাদা লাইন সঙ্গে সবুজ টেনিস কোর্ট
man stand on skateboard##skateboard,person,person,remote,skateboard	মানুষ স্কেটবোর্ডে দাঁড়িয়ে আছে
The front wheel of the second bus.##bus,bus,bus,bus	দ্বিতীয় বাসের সামনের চাকা।
Bizarre sculpture on a coffee stand##chair,couch,couch,chair,cake,dining table	একটি কফি স্ট্যান্ডে উদ্ভট ভাস্কর্য
large cement block##skateboard,person,person,person,person,skateboard,chair,person	বড় সিমেন্ট ব্লক
this stand is yellow in color##vase,vase,vase,vase,vase	এই স্ট্যান্ডটি হলুদ বর্ণের
date stamp of scene##chair,refrigerator,chair,bottle,potted plant,microwave,bottle,bottle,oven,microwave	দৃশ্যের তারিখ স্ট্যাম্প
Propellers too fast to see.##airplane	প্রোপেলাররা দেখতে খুব দ্রুত।
a block, yellow, and white baseball uniform##person,baseball glove,person,person,person,baseball bat,baseball bat,car	একটি ব্লক, হলুদ এবং সাদা বেসবল ইউনিফর্ম
players shoes are black, red, and white##person,baseball bat,person,person,baseball glove,person,person,person,person	খেলোয়াড়ের জুতা কালো, লাল এবং সাদা
The players are giving a high five##person,person,person,baseball glove,person,person,person,person,person,person	খেলোয়াড়রা উচ্চ পাঁচজন দিচ্ছেন
person has a stamp on her hand##person,sheep,person,cell phone,dog,person,bench,person,person,cow	ব্যক্তির হাতে একটি স্ট্যাম্প আছে
Copy right date 2010##airplane	সঠিক তারিখ 2010 অনুলিপি করুন
low grey wall behind players##person,person,person,baseball bat,person,baseball glove,person,person,person,person	খেলোয়াড়দের পিছনে কম ধূসর প্রাচীর
a green part of a tennis court.##person,frisbee	টেনিস কোর্টের সবুজ অংশ।
the second street light##traffic light,traffic light,traffic light,traffic light,traffic light,traffic light,traffic light,traffic light,traffic light	দ্বিতীয় স্ট্রিট লাইট
Two tennis players standing together##person,person,tennis racket,tennis racket,person,truck	দুই টেনিস খেলোয়াড় একসাথে দাঁড়িয়ে
two tennis players wearing black shorts##person,person,person,person,sports ball,sports ball,tennis racket,person,tennis racket,person	কালো শর্টস পরা দুই টেনিস খেলোয়াড়
the players socks are blue##person,person,person,person,sports ball,person,person,person,person,person	প্লেয়ার মোজা নীল হয়
A red date stamp##person,person	একটি লাল তারিখ স্ট্যাম্প
Monitor stand below monitor##tv,tv,keyboard,mouse,dining table	মনিটরের মনিটরের নীচে স্ট্যান্ড করুন
a manual press machine##person	একটি ম্যানুয়াল প্রেস মেশিন
long black pipe on display stand##umbrella,person,tv,bird	ডিসপ্লে স্ট্যান্ডে দীর্ঘ কালো পাইপ
male cross country skier##person,skis,skis	পুরুষ ক্রস কান্ট্রি স্কিয়ার
models of airplanes on the tables##airplane,person,person,person,person,person,person,person,person,person	টেবিলগুলিতে বিমানের মডেল
Man cross country skiing.##person,person,skis,bench,bench,person,car	ম্যান ক্রস কান্ট্রি স্কিইং।
the sign has white characters##stop sign	চিহ্নটিতে সাদা বর্ণ রয়েছে
red time stamp on the photo##clock,car,clock,clock,truck,car,clock	ছবির উপর লাল সময় স্ট্যাম্প
little girl standing on a tennis court##person,tennis racket	টেনিস কোর্টে দাঁড়িয়ে ছোট মেয়ে
man cross country skiing during race##person,person,person,person,person,skis,person,person,skis,person	ম্যান ক্রস কান্ট্রি স্কিইং রেসের সময়
Cement forms sticking out of ground.##zebra,zebra,zebra,zebra,zebra,zebra,zebra	সিমেন্ট ফর্ম স্থল থেকে দূরে থাকে।
Sandwich on the second shelf.##chair,chair,chair,sink,dining table,chair,dining table,chair,bowl,donut	দ্বিতীয় বালুচরে স্যান্ডউইচ।
the english muffins are toasted##sandwich,cup,bowl,sandwich,dining table,dining table	ইংলিশ মাফলিন টোস্ট করা হয়
yellow front of second train##train,train	দ্বিতীয় ট্রেনের হলুদ সামনে
models posing on motorcycle##person,person,person,person,person,motorcycle,car,car,car,handbag	মডেল মোটরসাইকেলের উপর অঙ্গবিন্যাস
This open-air stand takes place in Jamaica##person,banana,banana,banana,bowl,banana,bottle,bottle,bowl,banana	এই ওপেন-এয়ার স্ট্যান্ডটি জামাইকাতে স্থান নেয়
clear stand for controller##remote,book,remote,carrot	নিয়ামক জন্য স্পষ্ট অবস্থান
black armed forces name on wing##airplane,airplane,airplane	কালো সশস্ত্র বাহিনীর নাম উইংয়ে
second base found directly behind the pitcher##person,person,person,person,baseball bat,sports ball,baseball glove,baseball glove,baseball glove,baseball bat	কলসিটির পিছনে সরাসরি দ্বিতীয় বেস পাওয়া যায়
A cross on a tower.##clock,clock,boat	একটি টাওয়ারের উপরে একটি ক্রস।
picture taken at drive up fast food chain##person,motorcycle,person,car,car,car,car,car,backpack,truck	ড্রাইভ আপ ফাস্ট ফুড চেইন ছবি
two horses stand on hill##horse,horse	দুটি ঘোড়া পাহাড়ে দাঁড়িয়ে আছে
cross centered in curved panels##bicycle,bicycle,person,motorcycle,person	বক্র প্যানেল কেন্দ্রিক ক্রস
white stripes in road is a pedestrian cross walk##traffic light,bus,person,car,person,traffic light,car,car,car,person	রাস্তায় সাদা স্ট্রাইপগুলি একটি পথচারী ক্রস হাঁটা
Box springs of bed.##bed	বিছানা বক্স স্প্রিংস।
The water bottle on the side of the court.##person,tennis racket,person,person,person,person,person,bottle,person	কোর্টের পাশে জলের বোতল 
A small wave forms on the water.##person,surfboard,person,person	জলের উপর একটি ছোট তরঙ্গ গঠন করে।
a daytime picture of a couple cross country skiing##person,person,skis,skis,person	একটি দম্পতি ক্রস কান্ট্রি স্কিইংয়ের একটি দিনের চিত্র
Cars moving at a very fast speed##	গাড়িগুলি খুব দ্রুত গতিতে চলেছে
a tree on a city block##person,car,truck,person,car,car,person,umbrella,person,person	একটি শহরের ব্লকের একটি গাছ
a cement block wall##person,frisbee	একটি সিমেন্ট ব্লক প্রাচীর
computer monitor on the stand##chair,keyboard,chair,tv,tv,person,mouse,mouse,person,bottle	স্ট্যান্ডে কম্পিউটার মনিটর
snow on the trees at a cross-country ski race##person,person,person,person,skis,skis,person,person,parking meter,skis	ক্রস-কান্ট্রি স্কি রেসে গাছগুলিতে তুষার
the second engine of the train##boat,train,train,boat,car	ট্রেনের দ্বিতীয় ইঞ্জিন
a black music stand##chair,book,book	একটি কালো সঙ্গীত স্ট্যান্ড
chairs and tables on the side of the court##person,tennis racket,person,person,chair,tennis racket,chair,chair,kite,person	কোর্টের পাশে চেয়ার এবং টেবিল
Baseball travelling fast in the air##person,person,person,baseball bat,baseball glove,baseball bat,baseball glove,person,baseball glove,baseball glove	বেসবল দ্রুত বাতাসে ভ্রমণ করে
fast food soda cups##remote,remote,couch,laptop,book,bottle,couch,dining table,cat,cup	ফাস্ট ফুড সোডা কাপ
An old wooden stand shade##cow,umbrella	একটি পুরানো কাঠের স্ট্যান্ড শেড
red on players sleeve##person,baseball glove	খেলোয়াড়দের হাতা উপর লাল
a stand next to the sink##sink,bottle,bench,vase	বেসিন এর পাশে একটি স্ট্যান্ড
second hand on clock##clock,chair	ঘড়ির উপর সেকেন্ডের কাঁটা
four men on court##tennis racket,person,person,person,tennis racket,person,tennis racket,chair,chair,chair	কোর্টে চার জন
a block wall behind the man##person,motorcycle,cell phone,cell phone,tie	লোকটির পিছনে একটি ব্লক প্রাচীর
cross walk at intersection##bus,person,person,car,car,traffic light,traffic light,handbag,person,car	চৌরাস্তা ক্রস ওয়াক
large tennis court##person,tennis racket,tennis racket	বড় টেনিস কোর্ট
Child sitting cross-legged on the floor##cup,person,person,chair,chair,potted plant,dining table,chair,frisbee,chair	বাচ্ছাটি মেঝেতে পা ভাঁজ করে বসে আছে 
Man standing on a tennis court##person,person,chair,sports ball,tennis racket,chair,car,person,chair,bottle	টেনিস কোর্টে দাঁড়িয়ে মানুষ
yellow time date stamp##bus,car,car	হলুদ সময় তারিখ স্ট্যাম্প
Turnstyle entrance to court##person,tennis racket	কোর্টে টার্নস্টাইল প্রবেশ
horse running fast with cowboy on the back##person,horse,person,person,person,person,person,person,person,person	পেছনে কাউবয় সঙ্গে দ্রুত ঘোড়া
blue umbrella pole held fast by sand##umbrella,umbrella,umbrella,umbrella,umbrella,boat,umbrella,umbrella,umbrella,boat	নীল ছাতা মেরুটি বালি দ্বারা ধরে রাখা
blue wood life guard stand##person,person,person,surfboard,surfboard,person,surfboard,frisbee,surfboard,person	নীল কাঠের লাইফ গার্ড স্ট্যান্ড
gloves are in the players back pocket##person,person,person,person,person,baseball bat,person,chair,bottle,chair	গ্লাভস প্লেয়ারদের পিছনে পকেটে রয়েছে
seats in the stand##person,tennis racket,person,person,person,sports ball,chair,chair,chair,chair	স্ট্যান্ডে আসন
the players glove is black##person,baseball glove	খেলোয়াড়দের গ্লোভ কালো
a brown horse with an english saddle##horse,horse,person,person,dog,boat	একটি ইংরেজী জিনযুক্ত একটি বাদামী ঘোড়া
The canvas sits on the stand##person,boat,kite,umbrella,backpack,boat,chair,suitcase,car,boat	ক্যানভাস স্ট্যান্ডে বসে
a camera on a stand##tv,traffic light,suitcase	একটি স্ট্যান্ডে একটি ক্যামেরা
net of the tennis court##person,person,tennis racket,tennis racket,car	টেনিস কোর্ট নেট
man sitting in fruit stand##person,orange,banana,orange,orange,apple,banana,apple,orange,orange	মানুষ ফলের স্ট্যান্ডে বসে
grill press##hot dog,hot dog,hot dog,hot dog,hot dog,hot dog,hot dog,hot dog,hot dog,hot dog	গ্রিল প্রেস
cross on tower steeple##clock	টাওয়ার স্টেপল উপর ক্রস
ink stamp in the pencil box##book,cup,book,book,book,book,book,book,book,book	পেন্সিল বাক্সে কালি স্ট্যাম্প
small table lamp on the night stand##bed,chair,chair,remote,dining table	নাইট স্ট্যান্ডে ছোট টেবিল ল্যাম্প
series of curved forms around body##zebra	শরীরের চারপাশে বাঁকা ফর্ম সিরিজ
a clock on a wooden block##clock	কাঠের ব্লকের একটি ঘড়ি 
edge of a stamp##tennis racket,book,clock,vase,book,book,person,refrigerator	একটি স্ট্যাম্প প্রান্ত
a man sitting cross legged in the grass##person,surfboard,surfboard,surfboard,surfboard,surfboard,frisbee,potted plant,sheep,bird	একটি লোক ঘাসে পা ভাঁজ করে বসেছে
Right ear of the second cat##cat,cat,car	দ্বিতীয় বিড়ালের ডান কান
a fine bristled retractable brush##cup,toothbrush,bottle,cup,toothbrush,dining table,cell phone,apple,toothbrush	একটি সূক্ষ্ম ব্রিসলেড প্রত্যাহারযোগ্য ব্রাশ
A motorcyclist driving very fast##motorcycle,person	একজন মোটরসাইকেল চালক খুব দ্রুত গাড়ি চালাচ্ছেন
a baseball players bat##person,person,person,person,baseball bat,baseball glove,person,person,person,person	একটি বেসবল খেলোয়াড় ব্যাট
A second sandwich on a wrapper.##cup,sandwich,sandwich,person,dining table,sandwich,spoon	একটি মোড়কের উপর একটি দ্বিতীয় স্যান্ডউইচ।
case with cross on it also has red trim##laptop,laptop,backpack,backpack,backpack,handbag,backpack,backpack,suitcase,bottle	এটি ক্রস সঙ্গে কেস এছাড়াও লাল ছাঁটাই আছে
a railing on a second story balcony##person,umbrella,person,person,umbrella,person,person,person,bench,person	দ্বিতীয় তলের বারান্দায় একটি রেলিং
Two soccer players##person,person,person,person,person,sports ball,person,person,person,chair	দুই ফুটবল খেলোয়াড়
the cross on the top of the building structure##clock	বিল্ডিং কাঠামো শীর্ষে ক্রস
People waiting to cross street##car,traffic light,traffic light,person,car,car,car,person,car,car	রাস্তা পার হওয়ার অপেক্ষায় থাকা মানুষ
characters on the sign##	সাইন অক্ষর
A skateboard with asian characters painted on the underside##skateboard,bicycle,clock,bicycle,car,bicycle,truck,book	আন্ডারসাইডে আঁকা এশিয়ান অক্ষর সহ একটি স্কেটবোর্ড
fine inscriptions on item##clock,scissors,scissors	আইটেম উপর সূক্ষ্ম শিলালিপি
characters are posted in Chinese##train,clock	অক্ষরগুলি চীনা ভাষায় পোস্ট করা হয়
Man getting ready for a penalty kick##person,person,person,person,person,person,person,person,person,sports ball	পেনাল্টি কিকের জন্য প্রস্তুত মানুষ
A red cross forms on the floor.##train,person	মেঝেতে একটি লাল ক্রস গঠন।
many wires criss-cross overhead##	অনেক তারের ক্রাইস-ক্রস ওভারহেড
This could be at a science fair.##person,clock,chair,clock,person,cup,chair,bottle,bicycle,person	এটি একটি বিজ্ঞান মেলায় হতে পারে।
man using a hand press to make juice##person,orange,orange,cup,cup,orange,orange,orange,orange,baseball bat	মানুষ রস তৈরি করতে একটি হাত প্রেস ব্যবহার করে
The picture has a date stamp##potted plant,potted plant,potted plant,potted plant,potted plant,potted plant,potted plant,potted plant,potted plant,potted plant	ছবিটিতে একটি তারিখের স্ট্যাম্প রয়েছে
A date underneath a clock face##clock	একটি ঘড়ির মুখের নীচে একটি তারিখ
unfinished wood block under freezer##refrigerator,refrigerator	ফ্রিজারের অধীনে অসম্পূর্ণ কাঠের ব্লক
fast train moving along track##train	দ্রুত ট্রেন ট্র্যাক বরাবর চলমান
Three baseball players wearing white uniforms are in the background.##person,person,person,baseball glove,person,person,person,person,person,baseball glove	সাদা ইউনিফর্ম পরা তিনটি বেসবল খেলোয়াড় পটভূমিতে রয়েছে।
tennis player on the green colored section of a court##person,tennis racket,tennis racket	একটি কোর্টের সবুজ বর্ণের বিভাগে টেনিস খেলোয়াড়
making a very fast turn##person,person,skis,person,skis,person	খুব দ্রুত পালা করা
the tennis court net divides the court in the middle##person,person,tennis racket,tennis racket,person,person,person,person,sports ball,sports ball	টেনিস কোর্ট নেট মাঝখানে কোর্ট বিভক্ত
4 players on the court##person,person,sports ball,person,tennis racket,person	কোর্টে ৪ জন খেলোয়াড়
the chinese characters on the vase##cup,cup,vase,dog,potted plant,cup,vase	দানি উপর চীনা অক্ষর
crumbly english muffin bread##cup,sandwich,dining table	ঝুরঝুরে ইংলিশ মাফিন রুটি
a stand with information##person,vase	তথ্য সহ একটি স্ট্যান্ড
ad on the wall of the court##person,person,tennis racket,person,person,person,person,person,potted plant,sports ball	কোর্টের দেয়ালে বিজ্ঞাপন
The right front window on the second level of the bus.##bus,car,person,person,person,person,bus,person,person,person	বাসের দ্বিতীয় স্তরের ডান সামনের জানালা
the Asian characters are red##bus,car,traffic light,motorcycle,person,person,traffic light,person,person,person	এশীয় চরিত্রগুলি লাল
block tower on top of hill##clock,clock	পাহাড়ের উপরে ব্লক টাওয়ার
The black baseball mit on the players hand##person,baseball glove,sports ball	খেলোয়াড়দের হাতে কালো বেসবল মিট
yellow cross on a tie##tie,tie,tie,tie,tie,tie,tie,tie	একটি টাই উপর হলুদ ক্রস
five baseball players##person,baseball glove,person,person,person,person,person	পাঁচ বেসবল খেলোয়াড়
large date palm in the distance##giraffe,giraffe,person,person,person,person,person,person,person,person	দূরত্বে বড় খেজুর
Cows laying down in the hay at a county fair##cow,cow,cow,person,person,person,person,person,person,person	কাউন্টি মেলায় খড়ের গায়ে শুয়ে গাভী
armed forces identifying patch for US Army##person,bicycle,book,tv,book,tv,book,book,book,book	সশস্ত্র বাহিনী মার্কিন সেনাবাহিনীর জন্য প্যাচ চিহ্নিত করে
The tennis court is two different colors.##person,tennis racket,car,sports ball	টেনিস কোর্ট দুটি ভিন্ন রঙ।
A indoor tennis court.##person,person,person,sports ball,tennis racket,clock,tennis racket,tennis racket	একটি ইনডোর টেনিস কোর্ট।
characters on the edge of the plate##cake,dining table,cake	প্লেটের প্রান্তে অক্ষর
a fruit stand with lots of fruits and vegetables##banana,banana,banana,person,banana,banana,teddy bear,banana,banana,banana	প্রচুর ফল এবং সবজি সহ একটি ফল স্ট্যান্ড 
red white and blue truck is at the fair##horse,person,horse,person,person,person,truck,person,truck,truck	লাল সাদা এবং নীল ট্রাক মেলায়
yellow date taken stamp##giraffe	হলুদ তারিখ নেওয়া স্ট্যাম্প
Tarp on the side of the court##person,tennis racket,person,person,person,person,person,person,person,person	কোর্টের পাশে টার্প
Tall lights at the court##person,tennis racket,sports ball	দরবারে লম্বা লাইট
players standing behind chain link fence##person,person,person,person,person,person,baseball glove,person,baseball bat,car	চেইন লিঙ্ক বেড়া পিছনে দাঁড়িয়ে খেলোয়াড়রা
date stamp in the corner##bus,bus,bus,bus,bus,bus,bus,bus,bus,bus	কোণে তারিখ স্ট্যাম্প
a cross in a church##potted plant,knife,knife,chair,chair,chair,chair	একটি গির্জার ক্রস
easel stand for painting##elephant,person,person,person,person,umbrella,elephant,bench,person,person	পেইন্টিং জন্য ইজিল স্ট্যান্ড
owners manual for a panini press##cup,sandwich,sandwich,dining table,apple	একটি পানিনি প্রেসের জন্য মালিকদের ম্যানুয়াল
dog forms splashes in the water##dog,horse	কুকুর জল ছেটাচ্ছে
two long and narrow panes below cross bar##cat	ক্রস বারের নীচে দুটি দীর্ঘ এবং সরু ফলক
Double red doors on second floor##clock,clock,refrigerator	দ্বিতীয় তলায় ডাবল লাল দরজা
Partial view of second bus##bus,car,person,person,bus,person,person,person	দ্বিতীয় বাসের আংশিক দৃশ্য
White door on second floor##dog,truck,car,person	দ্বিতীয় তলায় সাদা দরজা
a romantic date night##person,person,bench,handbag,car	একটি রোমান্টিক তারিখ রাত
knife block sitting on counter with knives in it##oven,sink,spoon,spoon,knife,sink,sink,refrigerator,knife	এটিতে ছুরি নিয়ে কাউন্টারে বসে চাকু ব্লক
a block of buildings##person,traffic light	বিল্ডিং একটি ব্লক
Curved stairs on the approach to the court yard##potted plant	কোর্ট ইয়ার্ডে যাওয়ার জন্য বাঁকানো সিঁড়ি
chinese characters on the side of a bus##person,person,person,person,bus,train,handbag	একটি বাসের পাশে চীনা অক্ষর
blue tennis court##person,person,person,person,person,person,person,person,person,boat	নীল টেনিস কোর্ট
This person is waiting to cross the street##person,person,person,person,person,traffic light,car,person,person,person	এই ব্যক্তি রাস্তায় পারাপারের জন্য অপেক্ষা করছেন
The block for the post##bicycle,person,person,person,person,motorcycle,parking meter,handbag,sports ball	পোস্টের জন্য ব্লক
tan letters on the tennis court##person,sports ball,tennis racket	টেনিস কোর্টে ট্যান চিঠি
this license plate has non-english characters##umbrella,person,car,car,handbag,car,handbag,chair,potted plant,potted plant	এই লাইসেন্স প্লেটে অ-ইংরেজি অক্ষর রয়েছে
players uniform is black and gold##person,tennis racket,sports ball,sports ball,sports ball	খেলোয়াড়দের ইউনিফর্মটি কালো এবং সোনার
Watermark, showing copyright date.##airplane	ওয়াটারমার্ক, কপিরাইটের তারিখ দেখাচ্ছে।
name and website of photographer and Chinese characters##person,person,person,person,person,person,cake,person,remote	নাম এবং ফটোগ্রাফার এবং চীনা অক্ষর ওয়েবসাইট
tv on a stand##person,suitcase,couch,potted plant,suitcase,bowl,vase,bowl,dining table,couch	স্ট্যান্ডে টিভি
grass grows next to the block##motorcycle	ব্লকের পাশে ঘাস জন্মে
A paper towel roll on a stand##person,tie,tie,bottle	একটি স্ট্যান্ডে একটি কাগজের তোয়ালে রোল
white springs under mattress##bed,bed	গদিতে সাদা ঝর্ণা
The brick wall behind the court##person,person,person,person,tennis racket,sports ball,person,tennis racket	কোর্টের পিছনে ইটের দেয়াল
egg shaped object on a stand##person,toothbrush,sink,bottle	স্ট্যান্ডে ডিমের আকারের বস্তু
tennis ball shadow on the court##person,tennis racket,sports ball,tennis racket,frisbee	কোর্টে টেনিস বল ছায়া
littleyiye photographers stamp##vase,vase,chair,potted plant,potted plant,dining table,vase	ছোট্টই ফটোগ্রাফারদের স্ট্যাম্প
Picture stamped date 8/10/2013.##person,person,person,person,person,person,person,person,truck,person	ছবি স্ট্যাম্পড তারিখ 8/10/2013।
2010 date in black##person,person,person,person,baseball bat,person,person,baseball bat,person,person	২০১০ তারিখে কালো
sign above the people at the fair##person,surfboard,person,person,person,person,person,person,person,person	মেলায় লোকদের উপরে সাইন ইন করুন
Straight fine black hair##person,tie,baseball glove	সোজা সূক্ষ্ম কালো চুল
a horse with an english saddle##horse,horse,horse,person,person,horse,person,person,person,person	একটি ইংরেজী জিনযুক্ত একটি ঘোড়া
the baby has very fine hair##person,person,person	শিশুর খুব সুন্দর চুল রয়েছে has
pelican forms ripples with legs##bird,kite,umbrella,bird	পেলিকান পায়ে দিয়ে রিপ্লেস গঠন করে
A window on a second story shop.##motorcycle,motorcycle,potted plant,potted plant	দ্বিতীয় গল্পের দোকানে একটি উইন্ডো।
Green stand in the snow.##person,skis,skis	বরফে সবুজ স্ট্যান্ড।
display models of cell phones##person,cell phone,cell phone,cell phone,cell phone,cell phone,cell phone,person,cell phone,parking meter	সেল ফোন মডেল প্রদর্শন
black chinese characters n white sign##person,train,truck,person,bus,person	কালো চীনা অক্ষর এন হোয়াইট সাইন
Shadow of the man on the tennis court##person,tennis racket,sports ball,sports ball,sports ball,sports ball,sports ball,sports ball,sports ball	টেনিস কোর্টে লোকটির ছায়া
white marking on tennis court##person,tennis racket	টেনিস কোর্টে সাদা চিহ্ন
Baby fine light brown hair.##broccoli,person,bowl,broccoli,dining table,chair,person,cake,dining table	বাবু সূক্ষ্ম হালকা বাদামী চুল।
the players lean on the fence##person,person,person,person,person,person,baseball glove,person,person,baseball bat	খেলোয়াড়দের বেড়া উপর ঝুঁকুন
second suitcase on bottom is orange##suitcase,suitcase,suitcase,suitcase,suitcase,person,suitcase,suitcase,umbrella,suitcase	নীচে দ্বিতীয় স্যুটকেস কমলা হয়
Man helping child stand on snowboard##snowboard,person,person,person	শিশু স্নোবোর্ডে দাঁড়াতে সহায়তা করে লোক
extremely fast bullet train##train,train,person	অত্যন্ত দ্রুত বুলেট ট্রেন
Oriole on front of players hat##person,sports ball,baseball glove,person	ওরিওল খেলোয়াড়দের সামনে টুপি
Net across the tennis court##person,person,person,person,tennis racket,person,person,person,person,person	টেনিস কোর্ট জুড়ে নেট
second car parked on the street##car,car,car,car,car,car,traffic light,potted plant,train,traffic light	দ্বিতীয় গাড়ী রাস্তায় পার্ক
Cather's mit for hand protection against fast pitches.##person,person,baseball glove,person,person,person,person,person,person,person	দ্রুত পিচের বিরুদ্ধে হাত রক্ষার জন্য ক্যাথার মিট।
fast food chicken patty##sandwich,cell phone,bowl,dining table	ফাস্ট ফুড মুরগির প্যাটি
sunglasses of second rider##person,person,person,motorcycle,person,motorcycle,motorcycle,motorcycle	দ্বিতীয় রাইডারের সানগ্লাস
People buying food on fast food store##person,person,pizza,pizza,person,person,person,cup,vase,knife	লোকেরা ফাস্টফুড স্টোরে খাবার কিনে থাকে
second animal in the back##elephant,cow,potted plant,cow,potted plant	পিছনে দ্বিতীয় প্রাণী
the stand under the tv##tv,person,chair,couch,book,chair,bottle,refrigerator,chair,book	টিভির নীচে স্ট্যান্ড
tennis court with white stripes##person,tennis racket,sports ball	সাদা ফিতে সঙ্গে টেনিস কোর্ট
kick stand on motorcycle##person,person,person,motorcycle,motorcycle,person,person,motorcycle	মোটরসাইকেলের উপর কিক স্ট্যান্ড
chainlink fencing forms a field exit##person,person,person,baseball bat,bench,sports ball,traffic light,person,baseball bat,baseball glove	চেইনলিংক বেড়া একটি ক্ষেত্র প্রস্থান করে
Wall design of people characters.##person,tv,person,person,person,tv,person,person,person,person	মানুষের চরিত্রগুলির ওয়াল ডিজাইন।
the sidewalk in front of the produce stand##person,person,person,orange,apple,apple,handbag,person,orange,orange	উত্পাদনের স্ট্যান্ডের সামনের ফুটপাত
concrete or cinder block walls##elephant	কংক্রিট বা সিন্ডার ব্লক দেয়াল
The tv stand is made of wood##tv,chair,chair,chair,dining table,chair,chair,dining table,book,chair	টিভি স্ট্যান্ডটি কাঠের তৈরি
the models perky lips##person,tie	মডেল বেহায়া ঠোঁট
Three baseball players at first base##person,person,person	প্রথম বেসে তিনটি বেসবল খেলোয়াড়
block of black butcher knives##microwave,oven,knife,sink,knife,oven,sink,knife,oven,sink	কালো কসাই ছুরি ব্লক
pointing sign in english and chinese##umbrella,person,person,person,umbrella,person,person,person,car,person	ইংরাজী এবং চীনা মধ্যে সাইন ইন
Lamp on the night stand to the left of the bed##bed,chair,tv	বিছানার বাম দিকে নাইট স্ট্যান্ডে প্রদীপ
Date stamp of March 16th, 2008##person,bus,train	16 শে মার্চ, 2008 তারিখের ডাকটিকিট
coca cola international logo, written in english, probably repeated below##car,car,car,truck,car,person,car,person,person,person	কোকা কোলা আন্তর্জাতিক লোগো, ইংরেজিতে লেখা, সম্ভবত নীচে পুনরাবৃত্তি হয়েছে
a white sign with black Asian characters going vertically##motorcycle,person,person,person,person,person,person,motorcycle,handbag,car	কালো এশিয়ান অক্ষরগুলির সাথে একটি সাদা চিহ্ন 
bicycle stamp on road##traffic light,traffic light,bus,car,person,person,traffic light,person,person,traffic light	রাস্তায় সাইকেল স্ট্যাম্প
neon sign in a second floor window##person,car,car,person,car,car,person,car,person,car	দ্বিতীয় তল উইন্ডোতে নিয়ন সাইন
this couple is on a date##person,person,cup,cake,sink,chair,cup,cell phone,dining table,dining table	এই দম্পতি একটি তারিখে হয়
Mcdonald's advertisement in a language other than english##traffic light,traffic light,train	ইংরাজী ছাড়া অন্য ভাষায় ম্যাকডোনাল্ডের বিজ্ঞাপন
rolls of towels on stand##sink,bottle	তোয়ালে রোল স্ট্যান্ডে
many glorious forms of opportunistic weeds##boat,boat	সুবিধাবাদী আগাছা অনেক গৌরবময় ফর্ম
kids at a fair eating##person,pizza,person,person,person,car,person,pizza,person,person	বাচ্চাদের ন্যায্য খাওয়ার সময়
a block lower half of a wall##giraffe,giraffe	একটি দেয়ালের নীচে অর্ধেক ব্লক
jelly jar on top of a chopping block##bottle,bottle,knife,dining table,knife,hot dog,knife,sandwich	কাটা ব্লকের উপরে জেলি জার
yellow poles by the cross sign##train,traffic light,traffic light,traffic light,traffic light,traffic light	ক্রস চিহ্ন দ্বারা হলুদ খুঁটি
orange time and date stamp##person,potted plant,chair,chair,potted plant,toothbrush,toothbrush	কমলা সময় এবং তারিখ স্ট্যাম্প
Two female tennis players shaking hands##person,person,person,person,tennis racket,tennis racket,tennis racket	দুই মহিলা টেনিস খেলোয়াড় হাত কাঁপছেন
A wooden stand##person,surfboard,chair	একটি কাঠের স্ট্যান্ড
Four baseball players on field.##person,person,person,baseball bat,person,baseball glove,sports ball,baseball glove	মাঠে চার বেসবল খেলোয়াড়।
an American flag in the background of a press conference##person,person,person,tie,person,person,tie,person,cell phone,person	একটি সংবাদ সম্মেলনের পটভূমিতে একটি আমেরিকান পতাকা
two english spaniels standing near a person##dog,person,tie,dog	একজন ব্যক্তির কাছে দাঁড়িয়ে দুটি ইংলিশ স্প্যানিয়াল দাঁড়িয়ে
There is a book stand that is filled with books.##mouse,chair,cup,bottle,book,book,book,book,book,book	বইয়ের স্ট্যান্ড রয়েছে যা বই ভর্তি রয়েছে।
man taking pictures of players##person,person,person,person,tennis racket,person,person,person,person,person	মানুষ খেলোয়াড়দের ছবি তুলছে
Black hat with a red cross##person,person,person,skis,skis,skis,person	একটি লাল ক্রস সঙ্গে কালো টুপি
three baseball players standing in a row##person,person,person,baseball glove,person,person,person,baseball bat,tennis racket	তিনটি বেসবল খেলোয়াড় একটি সারিতে দাঁড়িয়ে
A black and brown dog fast asleep on the couch.##dog,couch,couch,dog,cat	একটি কালো এবং বাদামী কুকুর দ্রুত পালঙ্কে ঘুমিয়ে আছে।
the time stamp sitting in the corner##traffic light,person,train,train,person,traffic light,traffic light,traffic light,traffic light,fire hydrant	সময় স্ট্যাম্প কোণে বসে
yellow plane with characters##airplane,airplane,truck,person,airplane,person,truck,truck,truck,bus	অক্ষরের সাথে হলুদ বিমান
Buttons for pedestrians to cross the street##fire hydrant,car,person,car,car,traffic light,person,car,truck,person	রাস্তা পার হওয়ার জন্য পথচারীদের জন্য বোতাম t
A stand mixer##chair,microwave,dining table	একটি স্ট্যান্ড মিশুক
this players is shirtless##person,tennis racket,person,person,person,person,bottle,bottle,person,person	এই খেলোয়াড়রা শার্ট ছাড়া আছে
pattern on side of second giraffe##giraffe,giraffe	দ্বিতীয় জিরাফ পাশের প্যাটার্ন
a block on the ground##truck,bench,person	মাটিতে একটি ব্লক
bicycles in stand##person,bicycle,bicycle,person,bicycle,bicycle,bicycle,bicycle,bicycle,bench	সাইকেল দাঁড়ানো
a man photographs two baseball players##person,person,person,car,baseball bat,car,cell phone,car,handbag,truck	একজন লোক দুই বেসবল খেলোয়াড়ের ছবি
a red don't cross signal.##traffic light,car,car,car,car,traffic light,car,car,car,traffic light	একটি লাল ক্রস সংকেত না।
French coffee press##person,refrigerator,cup,cup,dining table,cake,bowl,chair,sink,cell phone	ফ্রেঞ্চ কফি প্রেস
black bicycle seat with supporting springs##cat,person,bicycle,bicycle,bicycle,bicycle,backpack,sheep	সমর্থনকারী স্প্রিংস সহ কালো সাইকেল আসন
propeller is moving fast##airplane,person,person,airplane	প্রোপেলার দ্রুত এগিয়ে চলেছে
toy models of buses##bus,bus,bus,bus,bus,bus,book,person,person,bus	খেলনা মডেল বাস
a motorcycle going fast##motorcycle,person	একটি মোটরসাইকেল দ্রুত যাচ্ছে
Shadow on the court##person,tennis racket,person,tennis racket,sports ball	কোর্টে ছায়া
A brick wall separating players and spectators.##person,person,person,baseball glove,baseball bat,person,person,person,chair,person	খেলোয়াড় এবং দর্শকদের পৃথককারী একটি ইটের প্রাচীর।
a fast moving hand##mouse,book,book,book,book,book,book,book,book,book	একটি দ্রুত চলন্ত হাত
The night stand is wooden.##bed	নাইট স্ট্যান্ডটি কাঠের।
baseball players posing together in an old photograph##person,person,person,person,person,person,person,person,person,person	বেসবল খেলোয়াড়রা পুরানো ছবিতে একসাথে পোজ দিচ্ছেন
Net across tennis court##person,person,tennis racket,tennis racket,person,person,sports ball,sports ball,tennis racket,tennis racket	টেনিস কোর্ট জুড়ে নেট
glass top on night stand##bed,vase,clock,clock	নাইট স্ট্যান্ডে গ্লাস টপ
raised cross on top of remote control##remote,person,book	রিমোট কন্ট্রোল শীর্ষে উত্থিত ক্রস
Grass growing on the grass tennis court.##person,tennis racket,sports ball	ঘাস টেনিস কোর্টে বাড়ছে ঘাস।
time stamp on the picture##person,teddy bear,teddy bear,book	ছবিতে সময় স্ট্যাম্প
two red metal springs##train	দুটি লাল ধাতুর ঝর্ণা
a a block in a wall##person,skateboard,skateboard,potted plant	একটি দেয়ালে একটি ব্লক
People looking to cross the road.##car,car,car,person,traffic light,person,car,person,person,person	লোকেরা রাস্তা পার হতে দেখছে।
the fair sky##horse,horse,horse	ফর্সা আকাশ
a motorcycle is parked in front of the road block##motorcycle,motorcycle,car,person,car,person,car,car,motorcycle,car	একটি মোটরসাইকেল রাস্তা ব্লকের সামনে দাঁড়িয়ে আছে
White striped pedestrian cross-walk painted on street.##person,person,person,person,person,person,person,traffic light,traffic light,kite	রাস্তায় সাদা স্ট্রিপযুক্ত পথচারী ক্রস-ওয়াক আঁকা।
Baseball team players in the dugout##person,person,person,baseball bat,baseball glove,person,person,person,frisbee,person	ডাগআউটে বেসবল দলের খেলোয়াড়রা
boy sitting cross legged##person,person,tie,person,person,person,tie,person,person,tie	ছেলে টি হাঁটু ভাঁজ করে বসে
The man's hand forms a fist##person,surfboard,surfboard	লোকটির হাত মুঠো হয়েছে
stand of bamboo##person,person,cell phone,potted plant,potted plant	বাঁশের স্ট্যান্ড
Statue honoring members of the armed forces##person,person,umbrella,person,person,person,umbrella,person,backpack,umbrella	সশস্ত্র বাহিনীর সদস্যদের সম্মান জানিয়ে প্রতিমা
men of forces wearing the dress uniforms##motorcycle,person,person,person,person,person,person,person,person,person	ইউনিফর্ম পোষাক পরা পুরুষদের বাহিনী 
Another stand and its owner##person,person,person,person,person,person,person,person,bench,person	আরেকটি স্ট্যান্ড এবং এর মালিক
A man stand next to a jeep.##person,person,person,skis,truck,suitcase,cell phone	একটা লোক জিপের পাশে দাঁড়িয়ে আছে।
The sign that says Alice springs##	সাইন এ এলিস স্প্রিংস লেখা
a sandwich on a block##sandwich,dining table,chair,bowl,knife	একটি ব্লকের উপর একটি স্যান্ডউইচ
red bags behind players feet##person,person,person,person,person,baseball bat,bench	খেলোয়াড়দের পায়ের পিছনে লাল ব্যাগ
Asian characters on side of building##person,bus,person,bicycle,person,person,person,person,person,person	বিল্ডিংয়ের পাশে এশীয় অক্ষর
The tennis player's shadow is on the tennis court.##person,tennis racket,sports ball,person,person,person,person,chair	টেনিস কোর্টে টেনিস খেলোয়াড়ের ছায়া।
fast looking yellow motorcycle##motorcycle,potted plant,motorcycle	দ্রুত গতির মোটর সাইকেল
white springs under bed##bed	বিছানার নিচে সাদা স্প্রিংগুলো 
a sponsors name on the tennis court wall##person,person,sports ball,chair,tennis racket	টেনিস কোর্ট প্রাচীর একটি স্পনসর নাম
Asian characters written on a sign##bus,bus,car,bus,car,person,car,car,bus,bus	একটি চিহ্নে লেখা এশীয় অক্ষর
the date and time indicating the time of picture##train,train,handbag	তারিখ এবং সময় ছবির সময় নির্দেশ করে
The light forms a rainbow##horse,horse,horse,cow,person	আলো একটি রংধনু গঠন করে
Headpiece of the second rider from the right##horse,horse,horse,horse,person,horse,horse,person,person,person	ডান থেকে দ্বিতীয় রাইডারের হেডপিস
postage stamp with liberty bell##cat,book,book,bowl,book	ডাকটিকেটে লিবার্টি বেল
Mud forms along the edge of the watering hole##giraffe,giraffe	জলের পাশে কাদা হয়েছে
an unfinished block of wood##scissors,bottle,knife,dining table,knife,remote,book	কাঠের একটি অসম্পূর্ণ ব্লক
green grass behind players##person,person,person,baseball glove,baseball glove,skis	খেলোয়াড়দের পিছনে সবুজ ঘাস
the second base coach watches the play##person,person,baseball glove,person,baseball glove,person,chair,person,person,person	দ্বিতীয় বেস কোচ খেলাটি দেখেন
child's soft fine brown hair##teddy bear,person,bed,person,person	বাচ্চার নরম সূক্ষ্ম বাদামী চুল
A black entertainment stand on wheels##tv,couch,chair,potted plant,potted plant,chair,chair,vase,potted plant,keyboard	একটি কালো বিনোদন স্ট্যান্ড চাকার উপর দাঁড়িয়ে 
fast motion image of woman walking in rain##person,umbrella	বৃষ্টিতে হাঁটা মহিলার দ্রুত গতির চিত্র
second story of building holds two balconies##horse,horse,person,motorcycle,person,person,person,person,person,person	বাড়ির দ্বিতীয় তলায় দুটি বারান্দা 
ovan kept in the stand##microwave,refrigerator,oven,knife,person,person,person,person,person,person	ওভান স্ট্যান্ডে রাখা
The speaker on the stand##person,tv,chair,laptop,chair,person,tv,laptop	স্ট্যান্ডে স্পিকার
a man in front of a produce stand##person,person,banana,banana,person,apple,apple,person,banana,banana	একটি পণ্য উত্পাদন স্ট্যান্ডের সামনে একজন মানুষ
a fast moving train##train,train	একটি দ্রুত চলন্ত ট্রেন
tennis players shadow on court##person,chair,chair,umbrella,chair,chair,chair,chair,chair,chair	কোর্টে টেনিস খেলোয়াড়ের ছায়া 
date stamp on photo is 8/23/08##person,person,cell phone,book,dining table	ছবিতে তারিখ স্ট্যাম্প 8/23/08 হয়
a man sitting on a cement block##person,dog,boat,boat,chair,boat,car,truck,chair,airplane	একজন সিমেন্টের ব্লকে বসে আছেন
several baseball players in the dugout##person,person,person,person,person,person,bench,bench,person,baseball glove	ডাগআউটে বেশ কয়েকটি বেসবল খেলোয়াড়
An orange time stamp##zebra,car,car,car,car	কমলা রঙের তারিখ স্ট্যাম্প 
the date is orange##zebra,zebra,zebra,sports ball,cow	তারিখ টি কমলা রঙের 
Grey block wall behind woman##person,cell phone,cell phone,cup	মহিলার পিছনে ধূসর ব্লক প্রাচীর
english muffin with egg and hollandaise##broccoli,carrot,sandwich,dining table,cup,hot dog,donut,sandwich	ডিম এবং হল্যান্ডাইজের সাথে ইংলিশ মাফিন
tail of elephant forms a circle##elephant,elephant,elephant,bird,bird	হাতির লেজ একটি বৃত্ত গঠন করে
plant is on a metal stand##potted plant,couch,couch,laptop,vase,dining table	ধাতব স্ট্যান্ডের উপর গাছ
stand for trays##person,book,book,oven,donut,oven,sink	ট্রে এর স্ট্যান্ড 
this is a blue court##person,tennis racket,sports ball,bench,sports ball	এটি একটি নীল কোর্ট
ginger with fair skin, orange hair, billions of freckles, and glasses##person,person,person,frisbee,frisbee,frisbee,person,chair,car	ফর্সা ত্বক, কমলা চুল, কোটি কোটি ফ্রিকলস এবং চশমাযুক্ত প্রানবন্ত ভাব 
facial expression, particularly mouth that says, 'yeah, i'm fine w/ being a corporate drone##person,tie	মুখের অভিব্যক্তি, বিশেষত মুখটি বলে যে 'হ্যাঁ, আমি বড় কোম্পানির কর্মচারী হয়ে ভাল আছি' 
white block on the street##dog,fire hydrant,dog,car,motorcycle,person,car,bus,stop sign,car	রাস্তায় সাদা ব্লক
boat forms ripples##boat,person	নৌকা লহর ফর্ম
child forces straws into a a can##person,cell phone,umbrella,cup,person	বাচ্ছাটি জোর করে ক্যান এর ভেতরে স্ট্র পুশ করে
Blue square on tennis court##person,tennis racket	টেনিস কোর্টে ব্লু স্কয়ার
the players tennis shoes are white##person,person,person,tennis racket,tennis racket,person,bottle,backpack,bench,sports ball	খেলোয়াড়দের টেনিস জুতো সাদা
sign denoting 2900 block##person,truck,car,car,car,car,car,car,car,car	2900 ব্লকটি চিহ্নিত করুন sign
books in a black stand##person,person,refrigerator,dog,book,book,cat,book,book	একটি কালো স্ট্যান্ড বই
date and time of picture##motorcycle,motorcycle,person,car,car,car,motorcycle,car,car,motorcycle	তারিখ এবং ছবির সময়
a train stop block##train,person,person	একটি ট্রেন স্টপ ব্লক
Snow covered cross walk##car,car,car,car,car,car,car,car,car,car	তুষার ঢাকা ক্রস ওয়াক
the steeple has a cross on top##clock	স্টিপলের উপরে একটি ক্রস রয়েছে
Soccer players in action##person,person,person,person,person,sports ball	অ্যাকশনে সকার খেলোয়াড়রা
tennis court in bounds area for doubles play##person,tennis racket,person,person,person,person,bird,person	ডাবল খেলার জন্য সীমান্ত অঞ্চলে টেনিস কোর্ট
english word in green##airplane,person,truck	সবুজ ইংরেজি শব্দ
Brown tennis court with white lines.##person,person,sports ball,person,person,tennis racket,person,person,person,person	সাদা লাইনে ব্রাউন ব্র্যান্ডের টেনিস কোর্ট।
A brown stand next to a wall.##chair,chair,chair,chair,chair,potted plant,dining table,potted plant,chair,potted plant	একটি দেয়ালের পাশে একটি বাদামী স্ট্যান্ড।
black iron gate with white cross##cow,cow,cow,truck,car,car,person,potted plant,person,person	সাদা ক্রস সঙ্গে কালো লোহার গেট
time stamp with red number##clock,potted plant	লাল নম্বর সহ সময় স্ট্যাম্প
stack of books on bed stand##bed,potted plant,vase,book,book,book,bed,vase,book	বিছানা স্ট্যান্ড বইয়ের স্তুপ
knife set in a wooden block##bottle,bottle,bottle,bottle,bottle,bottle,bottle,bottle,bottle,bottle	একটি কাঠের ব্লক মধ্যে ছুরি সেট
base ball diamond with players##person,person,person,person,person,person,person,person,person,person	খেলোয়াড়দের নিয়ে বেসবল ডায়মন্ড
Television in the tv stand.##person,potted plant,book,person,tv,book,person,book,vase,book	টিভি স্ট্যান্ডে টেলিভিশন।
second green sign from the top##	উপরে থেকে দ্বিতীয় সবুজ চিহ্ন
Date stamp 6/30/2013##train	তারিখ স্ট্যাম্প 6/30/2013
logo on the tennis court##person,tennis racket,sports ball	টেনিস কোর্টে লোগো
the necktie has a circle cross motif##person,tie,tie	নেকটি একটি বৃত্ত ক্রস মোটিফ আছে
a photographers stamp on the photo##airplane,airplane,airplane,airplane,airplane,airplane,airplane	ছবির উপর একটি ফটোগ্রাফার স্ট্যাম্প
block of green water in front of surfer##person,surfboard	সার্ফারের সামনে সবুজ জলের ব্লক
asian characters in red##person,person,person,person,car,person,truck,person,car,person	লাল এশিয়ান অক্ষর
A fine white sand##truck,person,person,person,person,person,dining table,person,person,umbrella	একটি সূক্ষ্ম সাদা বালি
night stand made of dark brown wood##bed,couch,bed	গাঢ় বাদামী কাঠের তৈরি নাইট স্ট্যান্ড
two players in ground##person,person,person,tennis racket	মাটিতে দুই খেলোয়াড়
brown mane on neck of second giraffe##giraffe,person,giraffe	দ্বিতীয় জিরাফের গলায় বাদামি কেশর
white engraved cross##teddy bear,teddy bear,person	সাদা খোদাই করা ক্রস
Red and silver sign with Asian characters##traffic light,car,person,car,person,person,car,person,person,car	এশীয় অক্ষরগুলির সাথে লাল এবং রৌপ্য সাইন
Woman getting ready to cross street##car,person,car,car,person,car,handbag,car,car,car	মহিলা রাস্তায় পার হতে প্রস্তুত
press board table top##sandwich,sandwich,person,bowl,sandwich,chair,sandwich,person	টেবিলের উপর প্রেসবোর্ড
the train is a fast speed train##train	একটি দ্রুত গতির ট্রেন
People at a fair.##person,person,person,person,person,person,person,person,person,person	মেলায় লোকজন।
a metal cross beam##giraffe,giraffe,giraffe,laptop,giraffe,chair	একটি ধাতব ক্রসবিম
players are playing baseball.##person,person,baseball glove,sports ball,tennis racket,person,sports ball	খেলোয়াড়রা বেসবল খেলছে।
railed porch on the second floor of a home##person,backpack,skateboard	একটি বাড়ির দ্বিতীয় তলায় বারান্দা 
Balconies on the second floor##person,book	দ্বিতীয় তলায় বালকিনিগুলি
a plate with white characters##stop sign	সাদা অক্ষরযুক্ত একটি প্লেট
The players wear uniforms.##person,person,person,person,person,person,person,person,person,person	খেলোয়াড়রা ইউনিফর্ম পরে।
photographers watermark and date##sports ball,person,person,person,person,person,person	ফটোগ্রাফারদের জলছবি এবং তারিখ
Red table with fast food above it##person,dining table,chair,donut,chair,bus,dining table,chair,sandwich	এর উপরে ফাস্ট ফুড সহ লাল টেবিল
woman cross her arms##person,person,person,person,person,person,cake,person,dining table,person	মেয়েটি হাত ভাঁজ করে
The tracks cross here##train,train,person,person,bus,person,person,person	ট্র্যাকগুলি এখানে পার হয়
"orange ""do not cross"" sign##car,fire hydrant,potted plant,traffic light,traffic light,traffic light,traffic light,person"	"কমলা ""ক্রস করবেন না"" চিহ্ন"
A person standing at the food stand.##chair,person,chair,chair,tv,chair,chair,chair,dining table,chair	খাবার স্ট্যান্ডে দাঁড়িয়ে একজন ব্যক্তি।
Three players are wearing helmet.##person,person,person,baseball glove,person,baseball bat,person,person,person,person	তিনজন খেলোয়াড় হেলমেট পরেছেন।
a non english sign##car,car,car,car,car,car,truck,car,car,bus	একটি অ ইংরেজী সাইন
player running on court##person,person,tennis racket,person,person,person,person,person,person,person	খেলোয়াড় কোর্টে চলছে
the woman on the court##person,person,person,person,person,person,person,person,person,person	কোর্টে মহিলা
A round concert block##toilet,spoon,spoon	একটি বৃত্তাকার কনসার্ট ব্লক
fast food items on plates##dining table,hot dog,bowl,donut,bottle	প্লেটগুলিতে ফাস্ট ফুড আইটেম
Top window pane in the left corner of the second story window##teddy bear,clock,person,teddy bear,handbag,donut	দ্বিতীয় গল্পের উইন্ডোর বাম কোণে শীর্ষ উইন্ডো ফলক
boundary lines on court##person,person,person,person,person,person,tennis racket,person,person,person	কোর্টে সীমানা লাইন
second wooden vertical slat from left##bench	বাম থেকে দ্বিতীয় কাঠের উল্লম্ব স্লট
A stand of trees along the edge of the lake##person,hot dog	হ্রদের কিনারায় গাছের স্ট্যান্ড
a blue and white cross walk sign##person,person,skateboard,skateboard,car,car,car	একটি নীল এবং সাদা ক্রস ওয়াক সাইন
open door of a second bus##suitcase,person,suitcase,person,bus,suitcase,backpack,person,suitcase,person	দ্বিতীয় বাসের দরজা খোলা
floral box springs under mattress##person,bowl,bed,chair,donut	গদি অধীনে ফুলের বক্স স্প্রিংস
street sign advising of penalty##car,person,traffic light,car,car,car,car,car,person,car	রাস্তার সাইন জরিমানার পরামর্শ
oranges and pears on the second layer of a fruit tree rack##banana,apple,apple,broccoli,orange,broccoli,orange,orange,dining table,broccoli	একটি ফলের গাছের র্যাকের দ্বিতীয় স্তরে কমলা এবং নাশপাতি
A skier going down fast on a slope##person,skis,skis	একজন ierালুতে দ্রুত নেমে একটি স্কাইয়ার
an english saddle above a saddle pad##horse,person,horse,person,horse,person,stop sign,horse,tie	একটি স্যাডল প্যাডের উপরে একটি ইংরেজী স্যাডল
four shadowy forms of giraffes seemingly looking forward##giraffe,giraffe,giraffe,giraffe	জিরাফের চারটি ছায়াময় রূপগুলি আপাতদৃষ্টিতে অপেক্ষা করছে
dirty concrete wall behind players##person,person,car,sports ball,cup,baseball bat	খেলোয়াড়দের পিছনে নোংরা কংক্রিট প্রাচীর
a couple of elephants photoshopped to stand out##elephant,elephant,elephant,elephant,elephant,elephant,elephant,elephant,elephant	বাইরে দাঁড়িয়ে বেশ কয়েকটি হাতির ফটোশপ করলেন
The fast moving subway train##train,person,person,bottle,carrot,bottle,train	দ্রুত চলমান সাবওয়ে ট্রেন
the net between the two players##person,person,tennis racket,tennis racket	দুই খেলোয়াড়ের মধ্যে নেট
Baseball glove on players left hand##person,person,baseball glove,sports ball,baseball glove	খেলোয়াড়দের বাম হাতে বেসবল গ্লোভ
silver and black french coffee press on shelf##dog,potted plant,potted plant,potted plant,potted plant,bottle,cup,potted plant	বালুচর উপর সিলভার এবং কালো ফরাসি কফি প্রেস
grey block in sidewalk##car,car,car,car,car,car,car,car,car,person	ফুটপাতে ধূসর ব্লক
short tan entertainment stand##chair,chair,couch,tv,potted plant,bottle,tv,vase,book,vase	সংক্ষিপ্ত ট্যান বিনোদন স্ট্যান্ড
A wooden block holding up the boat##boat	একটি কাঠের ব্লক যা নৌকাকে চেপে ধরে
fence next to players##person,person,baseball bat,sports ball,baseball bat,sports ball	খেলোয়াড়দের পাশে বেড়া
Oranges on a fruit stand##orange,orange,orange,orange,orange,orange,orange,orange,orange,orange	ফলের স্ট্যান্ডে কমলা
a butcher block with knives##oven,vase,traffic light	ছুরি দিয়ে কসাই ব্লক
Cluttered night stand##bed,book,vase,book,book,book,book,book	বিশৃঙ্খলা নাইট স্ট্যান্ড
tan house with lighter colored second floor##car,car,car,fire hydrant,car,car,car	হালকা রঙ্গিন দ্বিতীয় তল সঙ্গে ট্যান ঘর
two white chairs on tennis court##person,chair,chair,tennis racket,chair,person,person,sports ball,person,person	টেনিস কোর্টে দুটি সাদা চেয়ার
a cross railway sign##stop sign,train,train	একটি ক্রস রেলওয়ে সাইন
a triangle forms on brick##toilet,toilet	একটি ত্রিভুজ ইট উপর ফর্ম
A fast boat with people in it##boat,person	এতে লোকজনের সাথে একটি দ্রুত নৌকা
People waiting to cross street.##bus,traffic light,person,person,person,person,person,person,person,person	রাস্তা পার হওয়ার অপেক্ষায় থাকা মানুষ।
the button to press for the light is below the signal##person,car,skateboard,traffic light,person	আলোর জন্য চাপতে বোতামটি সিগন্যালের নীচে
dirt ground elephants stand on##elephant,elephant	ময়লা গ্রাউন্ড হাতি দাঁড়িয়ে আছে
the springs on the motorcycle##motorcycle,person,person,person,motorcycle,person,person,frisbee,person,traffic light	মোটরসাইকেলের ঝর্ণা
marked pedestrian cross walk##stop sign,fire hydrant,car	পথচারী ক্রস ওয়াক চিহ্নিত
The water is flowing fast##person,boat,person,person,surfboard,surfboard	জল দ্রুত প্রবাহিত হয়
The word AUG in the date##remote,person,remote,person,book,couch,bed,person,person,person	তারিখের এওজি শব্দটি
wooden slat that forms back of bench.##bench,car	কাঠের স্লট যা বেঞ্চের পিছনে গঠন করে।
the two male players are after the ball##person,person,person,sports ball,person,person,person,person,motorcycle,person	দুই পুরুষ খেলোয়াড় বল পরে আছেন
power lines cross in the air##traffic light,person	শক্তি লাইন বাতাসে অতিক্রম
area next to pot stand##vase	পট স্ট্যান্ডের পাশের অঞ্চল
fast food in the backgrond##bench,person,person,person,person,person,person,person,person,handbag	ব্যাকগ্রাউন্ডে ফাস্টফুড
this is a concrete yellow block##umbrella,umbrella,umbrella,person,umbrella,person,umbrella,umbrella,umbrella,umbrella	এটি একটি কংক্রিট হলুদ ব্লক
shadow on tennis court.##person,tennis racket,sports ball	টেনিস কোর্টে ছায়া।
tennis court marked with white color##person,tennis racket,person,car,car,bench	টেনিস কোর্ট সাদা রঙের সাথে চিহ্নিত
a green Christmas tree stand##person,tie,book,book,book,book,book,book,book,book	সবুজ ক্রিসমাস ট্রি স্ট্যান্ড
a business man waiting to cross the street##person,person,person,car,truck,handbag,traffic light,person,person,person	একজন ব্যবসায়ী লোক রাস্তা পার হওয়ার অপেক্ষায়
A white stand mixer##person,person,oven,oven,bowl,cup,cup,cup,bowl,book	একটি সাদা স্ট্যান্ড মিশুক
The time stamp is red.##stop sign,car,car,truck	সময় স্ট্যাম্প লাল।
cross section of a broccoli stem##broccoli,broccoli,broccoli,broccoli,broccoli,broccoli,broccoli,broccoli,broccoli,broccoli	একটি ব্রোকলি স্টেম ক্রস বিভাগ
players in the dugout.##person,baseball bat,person,person,person,person,person,person,person,person	খেলোয়াড়
a green fence at a tennis court##person,person,person,person,person,umbrella,person,person,person,person	টেনিস কোর্টে সবুজ বেড়া
person playing tennis on the court##person,tennis racket,person,chair,person,chair	ব্যক্তি কোর্টে টেনিস খেলছে
Man trying to block the throwing of a frisbee##person,person,person,frisbee,sports ball,chair,sports ball,chair,chair,chair	মানুষ একটি ফ্রিসবি নিক্ষেপ করার চেষ্টা করছে
the balcony on the second floor##truck,bus,bus,truck,truck	দ্বিতীয় তলায় বারান্দা
Red dragon fruit on a fruit stand.##person,banana,banana,banana,banana,banana,banana,banana,banana,banana	একটি ফলের স্ট্যান্ডে লাল ড্রাগন ফল।
person setting in second seat of bus##person,bus,person,person,person,person,car,handbag,person,handbag	ব্যক্তি বাসের দ্বিতীয় সিটে বসছে
The body of the stand up lamp.##chair,chair,tv,dining table,couch,dining table,dining table,chair,chair	দেহের স্ট্যান্ড আপ ল্যাম্প।
The players are male.##person,person,baseball glove,sports ball	খেলোয়াড়রা পুরুষ।
A fence at a tennis court##person,person,person,sports ball,backpack,chair,backpack	টেনিস কোর্টে একটি বেড়া
the date says 7-1##refrigerator,person,refrigerator,person,refrigerator,person,person,person,person,person	তারিখটি 7-1 বলে
picture hanging in the wall with anime characters##mouse,keyboard,mouse,tv,cup,tv,laptop,bottle,person,person	এনিমে অক্ষরগুলির সাথে দেয়ালে ঝুলন্ত ছবি
a grill press##person,hot dog,hot dog,hot dog,hot dog,hot dog,hot dog,hot dog,hot dog,hot dog	একটি গ্রিল প্রেস
Bird models suspended in shopping mall.##bird,person,person,person,person,bird,person,person,person,person	শপিং মলে বার্ড মডেলগুলি স্থগিত করা হয়েছে।
green wall on tennis court##person,sports ball,person,person,person,chair,person,person,person,person	টেনিস কোর্টে সবুজ প্রাচীর
Woman in an english style saddle##person,horse,person,person,person,person,person,person,person,bottle	মহিলা একটি ইংলিশ স্টাইলের স্যাডলে
Photo date stamp##person,chair,chair,chair,couch,clock,chair,potted plant,clock,clock	ছবির তারিখ স্ট্যাম্প
the copyright and date stamp of the photographer##teddy bear,teddy bear,person,potted plant,potted plant,chair,chair,cup,book,dining table	ফটোগ্রাফারের কপিরাইট এবং তারিখ স্ট্যাম্প
a man stand on dock##boat,person,person,person,boat	একজন লোক ডকের উপরে দাঁড়িয়ে আছে
two players wearing white shorts##person,person,person,person,tennis racket,person,chair,person,person,person	সাদা শর্টস পরা দুই খেলোয়াড়
People on the court playing tennis.##person,person,tennis racket,bench,tennis racket	টেনিস খেলে কোর্টে লোকেরা।
A blue fine on the surf board.##person,person,person,truck,surfboard,person,truck	সার্ফ বোর্ডে একটি নীল জরিমানা।
White potted flowers on the tennis court##person,potted plant,tennis racket,potted plant	টেনিস কোর্টে সাদা পাত্র ফুল
a toasted english muffin##fork,cup,knife,carrot,dining table,cake,carrot,cake,knife,cup	একটি টোস্টড ইংলিশ মাফিন
Baseball player stealing second base##person,person,person,baseball glove,bed,person	বেসবল খেলোয়াড় দ্বিতীয় বেস চুরি
a date stamp for 2010/02/07##cow,cow,boat,cow,cow	2010/02/07 এর জন্য একটি তারিখ স্ট্যাম্প
second story of house##person,baseball bat,sports ball	বাড়ির দ্বিতীয় গল্প
Blue cross window on second floor##bus,person,person	দ্বিতীয় তলায় নীল ক্রস উইন্ডো
bird characters on top of a brown cake##cake,bird,bird,bird,bird	একটি বাদামী পিষ্টকের উপরে পাখির অক্ষর
a advertisement for highland springs##person,person,tennis racket,tennis racket,person,person,person,person,person,person	পার্বত্য অঞ্চলের ঝর্ণা জন্য একটি বিজ্ঞাপন
the tennis court is made of grass##person,person,person,tennis racket,person,person,person,person,person,person	টেনিস কোর্ট ঘাস দিয়ে তৈরি
a line of runway models##person,person,person,person,person,person,person,person,person,person	রানওয়ে মডেলগুলির একটি লাইন
yellow numbers showing the date##sink,sink,toothbrush,kite	হলুদ সংখ্যা তারিখ দেখাচ্ছে
A women skiing fast.##person,skis	একজন মহিলা দ্রুত স্কিইং করছেন।
cross country ski racers skiing up a hill.##person,person,person,person,person,person,person,person,person,person	ক্রস কান্ট্রি স্কি রেসাররা একটি পাহাড়ের উপরে স্কিইং করছে।
Three women soccer players sitting on a bench.##person,person,sports ball,person,person,person,person,backpack,person,backpack	তিনজন মহিলা ফুটবল খেলোয়াড় একটি বেঞ্চে বসে।
decaying amazing building that looks like something between an aztec and buddhist shrine in the english countryside##cow,cow	ক্ষয়িষ্ণু বিস্ময়কর বিল্ডিং যা দেখতে ইংরাজির পল্লীতে অ্যাজটেক এবং বৌদ্ধবাদী মাজারের মাঝে কিছু মনে হচ্ছে
A pot is fitted in a stand.##bowl,microwave,bowl,spoon,book,oven,cup,book,toothbrush,book	একটি স্ট্যান্ডে একটি পাত্র লাগানো হয়।
Safety railing on second story of building##person,person,umbrella,motorcycle,person,person,car,person,person,umbrella	বিল্ডিংয়ের দ্বিতীয় গল্পের সুরক্ষা রেলিং
Man sits floor cross legged##suitcase,dog,person,person,person,suitcase,suitcase,baseball bat,person,suitcase	মানুষ মেঝে ক্রস পায়ে বসে
White writing on a blue court.##person,person,tennis racket,person,person,person,person,bench,person,person	নীল দরবারে সাদা লেখা।
a very fast baseball##person,person,person,person,baseball glove,person,person,person,person,person	খুব দ্রুত বেসবল
White clock face with brown characters##clock,stop sign,spoon,traffic light	বাদামী বর্ণের সাথে সাদা ঘড়ির মুখ
buildings are behind the road block##truck,person,car,handbag,car,truck,car	রোড ব্লকের পিছনে ভবনগুলি
Young woman in grey sweatshirt hoping to block frisbee.##person,person,frisbee,person,person,person,person,person,person,car	ফ্রিসবি ব্লক করার আশায় ধূসর সোয়েটশার্টে যুবতী।
people on the second floor##person,person,person,person,person,person,person,person,person,person	দ্বিতীয় তলায় মানুষ
a red dirt tennis court##person,sports ball,tennis racket	একটি লাল ময়লা টেনিস কোর্ট
Black block with number on it##person	এটিতে নম্বর সহ ব্লক ব্লক
stuffed disney characters##person,cup,bed,teddy bear,teddy bear,person	স্টাফ ডিজনি অক্ষর
players waiting in dugout##person,person,person,person,person,baseball glove,person,person,person,baseball bat	খেলোয়াড় dugout মধ্যে অপেক্ষা
baseball players white pants##person,person,baseball bat,baseball glove,baseball glove	বেসবল খেলোয়াড় সাদা প্যান্ট
A motorcycle kick stand.##motorcycle,potted plant,person,person,motorcycle,motorcycle,motorcycle	একটি মোটরসাইকেলের কিক স্ট্যান্ড।
There is some fine sand here##umbrella,person,person,bench	এখানে কিছু সূক্ষ্ম বালি আছে
a metal orange juice press##chair,cup,orange,chair,chair,orange,apple,orange,carrot,donut	একটি ধাতব কমলা রস প্রেস
a baseball players uniform##person,baseball glove,sports ball,person,person,person,person,person,person,person	একটি বেসবল খেলোয়াড় ইউনিফর্ম
Three baseball players on baseball field.##person,person,person,person,baseball bat,person,baseball glove,baseball glove,baseball glove,person	বেসবল মাঠে তিন বেসবল খেলোয়াড়।
Booths at a street fair.##person,person,person,vase,handbag,umbrella,sandwich,dining table,sandwich,person	রাস্তার মেলায় বুথ।
Back right foot of the second goat##sheep,sheep,couch	দ্বিতীয় ছাগলের ডান পা পিছনে
fine toothed blade of knife##scissors,knife,scissors,scissors,person,knife,knife,knife,cell phone	ছুরি জরিমানা দাঁতযুক্ত ফলক
guy's hand trying to block the camera##laptop,person	লোকটির হাত ক্যামেরাটি ব্লক করার চেষ্টা করছে
Baseball in players right hand##person,person,baseball glove,baseball glove,person,person,sports ball	খেলোয়াড়দের ডান হাতে বেসবল
The second highest rail of the jump##person,horse,umbrella,umbrella	লাফের দ্বিতীয় সর্বোচ্চ রেল
a white paper not in english##person,motorcycle,motorcycle,motorcycle,motorcycle,person,motorcycle,motorcycle,car,person	একটি সাদা কাগজ ইংরেজি না
green and white concession stand near umbrella##person,person,person,frisbee,person,person,person,person,person,umbrella	ছাতার কাছাকাছি সবুজ এবং সাদা ছাড়
metal stand for ropes##bowl,bowl,dining table,bowl,sink,dining table,book,bowl,bowl,chair	দড়ি দড়ি জন্য স্ট্যান্ড
an umbrella standing in a tennis court##person,person,person,chair,chair,person,umbrella,tennis racket,backpack,umbrella	টেনিস কোর্টে একটি ছাতা দাঁড়িয়ে আছে
there are english and Chinese characters##traffic light	ইংরেজি এবং চীনা অক্ষর আছে
a bench along a tennis court##person,person,person,person,sports ball,kite,bottle,bottle	টেনিস কোর্ট বরাবর একটি বেঞ্চ
a young girl with a fair complexion##person,person,person,teddy bear,person,person,backpack,backpack,person,person	একটি ফর্সা বর্ণের সঙ্গে একটি যুবা মেয়ে
The players uniform is white##person,person,person,person,person,person,chair,baseball bat,chair,chair	খেলোয়াড়দের ইউনিফর্ম সাদা
a motorcycle side stand##motorcycle,potted plant	মোটরসাইকেলের সাইড স্ট্যান্ড
The second clock showing on the tower.##clock,clock	টাওয়ারে দেখানো দ্বিতীয় ঘড়ি।
tennis court floor##person,person,person,tennis racket,person,person,person,person,person,person	টেনিস কোর্ট ফ্লোর
cross on top of steeple##horse,horse,horse,horse,person,traffic light,person,person,clock,person	স্টেপল উপর ক্রস
the players are on a field##frisbee,person,person,person,person,car,sports ball,sports ball,car	খেলোয়াড়রা একটি মাঠে আছে
the second car in the train##train,person	ট্রেনের দ্বিতীয় গাড়ি
A TV stand sitting under TV##tv,person,chair,tv,person,chair,chair,chair,person	টিভির নিচে বসে একটি টিভি স্ট্যান্ড
two young softball players sitting on the bench##person,person,baseball glove,bench	দুই তরুণ সফটবল খেলোয়াড় বেঞ্চে বসে আছেন
man on a tennis court on a sunny day##person,tennis racket	টেনিস কোর্টে এক রোদ রোজ মানুষ
mass sheep and woolcraft fair ribbon##carrot,carrot,sheep,sheep,sheep,sheep,sheep,teddy bear,sheep,bird	ভর মেষ এবং উলক্রাফট মেলা ফিতা
the combs are fine##bench	ঝুঁটি ভাল আছে
cap on players head##person,baseball glove,sports ball	খেলোয়াড়দের মাথায় ক্যাপ
the models are red and black##car,car,chair,truck	মডেলগুলি লাল এবং কালো
Green and red tennis court##person,sports ball,person,person,person,person,person,person,person,person	সবুজ এবং লাল টেনিস কোর্ট
a celtic cross stone monument##sheep,sheep,sheep,sports ball,sheep,parking meter,sheep,sheep	একটি সেল্টিক ক্রস পাথর স্মৃতিস্তম্ভ
plants behind toy models##train	খেলনা মডেল পিছনে গাছপালা
wave is moving fast##person,surfboard	তরঙ্গ দ্রুত গতিতে চলছে
red double decker bus with Chinese characters and number 8##bus,car,person,traffic light,car,person,traffic light,person,person,person	চীনা অক্ষর এবং 8 নম্বর সহ লাল ডাবল ডেকার বাস
this shop sells fine ales##fire hydrant,book,book	এই দোকান জরিমানা বিক্রি করে
orange street block##skateboard,person,person,person	কমলা স্ট্রিট ব্লক
cross section of fans at baseball game##person,baseball glove,person,person,person,person,person,person,person,person	বেসবল খেলায় ভক্তদের ক্রস বিভাগ
large soft drink cup from a fast food restaurant or store##remote,laptop,cup,chair,person,keyboard,dining table,remote,keyboard	একটি ফাস্ট ফুড রেস্তোঁরা বা স্টোর থেকে বড় সফট ড্রিঙ্ক কাপ
red bananas at a fruit stand##banana,banana,banana,apple,banana,apple,apple,apple,apple,apple	একটি ফল স্ট্যান্ডে লাল কলা
train moving fast blurring image##backpack,person,person,person,bicycle,person,person,person,bus,backpack	দ্রুত চলা ট্রেনের ঝাপসা ছবি
this sign is not in english##bicycle,person,car,person,person,bus,person,person,truck,person	এই চিহ্নটি ইংরেজিতে নেই
an apple cider press##person,person,person,apple,bottle,apple,apple,apple,apple,apple	একটি আপেল সিডার প্রেস
Black tv on top of brown stand.##tv,vase,vase,couch,potted plant,potted plant,vase,book,couch,potted plant	ব্রাউন স্ট্যান্ডের উপরে কালো টিভি।
a hand moving too fast for the camera##laptop,person,person,person,potted plant,cell phone,person,person,hot dog,hot dog	একটি হাত ক্যামেরার জন্য খুব দ্রুত গতিতে চলেছে
Starps on the stand.##chair,tv,couch,couch,chair,chair,remote,chair,dining table,vase	স্ট্যান্ডের উপর স্ট্র্যাপ্গুলো
medium brown wood fine grained table##fork,dining table,laptop,dining table,spoon	মাঝারি বাদামী কাঠ সূক্ষ্ম দানযুক্ত টেবিল
Back of court is green.##person,person,tennis racket,person,tennis racket	কোর্টের পিছনে সবুজ।
white trail that can only be made by incredibly fast planes##airplane	সাদা ট্রেইল যা কেবল অবিশ্বাস্যভাবে দ্রুত প্লেন দ্বারা তৈরি করা যায়
score card being held by a man on tennis court##person,person,person,tennis racket,sports ball	টেনিস কোর্টে একজন লোক দ্বারা স্কোর কার্ড রাখা হচ্ছে
Man seated at food court table##person,chair,person,person,chair,person,person,person,person,person	মানুষ ফুড কোর্টের টেবিলে বসে আছে
black cap on players head##person,person,person,person,person,person,person,person,person,chair	খেলোয়াড়দের মাথায় ব্ল্যাক ক্যাপ
sydney written in white letters on court##person	সিডনি কোর্টে সাদা অক্ষরে লেখা
fine whiskers on animal's chin##cow,bench	পশুর চিবুক উপর সূক্ষ্ম চুল
a green chair on a tennis court##person,tennis racket,chair,chair,chair	টেনিস কোর্টে একটি সবুজ চেয়ার
Dollar amount of the penalty.##traffic light	জরিমানার ডলার পরিমাণ।
Baseball catcher watching players##person,person,person,person,person,person,person,person,person,chair	খেলোয়াড়দের দেখছেন বেসবল ক্যাচার
white Arabic characters on sign##stop sign,person,suitcase	সাইন ইন সাদা আরবী অক্ষর
poster with cartoon characters##person,laptop,mouse,person,bottle,chair,bird,chair,keyboard,mouse	কার্টুন চরিত্রযুক্ত পোস্টার
A time date stamp in the corner##truck,traffic light,train,truck	কোণে একটি সময় তারিখ স্ট্যাম্প
window planters outside second story##bus,person,person,person,person,bicycle,bicycle,bicycle,bicycle,person	দ্বিতীয় তলের বাইরে উইন্ডো রোপনকারীরা
green floor next to court##person,person,person,person,person,tennis racket,person,person,person,person	কোর্টের পাশের সবুজ তল
The boy has a orange stamp on his hand.##person,zebra,car,toilet	ছেলেটির হাতে কমলা স্ট্যাম্প রয়েছে।
black mit in players hand##person,person,person,person,person,handbag,person,baseball glove,person,person	খেলোয়াড়দের হাতে কালো এমআইটি
cross next to the clock tower##clock,car	ঘড়ির টাওয়ারের পাশ দিয়ে পার
sheep running really fast##sheep,sheep,sheep	মেষ সত্যিই দ্রুত চলমান
advertising to the state fair is mounted on the lamp post##	রাষ্ট্র মেলায় বিজ্ঞাপন প্রদীপ পোস্টে লাগানো হয়
bed pillow with cartoon characters on it##bed,person,person,person,book,person,book	এটিতে কার্টুন চরিত্রগুলি সহ বিছানার বালিশ
tennis court being used in a match##person,person,person,person,chair,person,person,chair,person,chair	টেনিস কোর্ট একটি ম্যাচ ব্যবহার করা হচ্ছে
Knives in wood block##toaster,chair,chair,chair,bottle,knife,dining table,knife,knife,oven	কাঠের ব্লকে ছুরি
part of the ball field with players getting ready to play##person,person,baseball glove,person,person,person,person,person,person,person	খেলোয়াড়দের খেলতে প্রস্তুত হয়ে বল মাঠের একটি অংশ
the weather is fair##person,skis,skis,backpack,backpack,backpack,backpack,backpack	আবহাওয়া ভাল
cement block siding on church##clock,person,person,clock,handbag,backpack,traffic light	গির্জার উপর সিমেন্ট ব্লক সাইডিং
a man in the armed forces##person,person,frisbee,backpack,truck,truck,car,car,car	সশস্ত্র বাহিনীর একজন
The car is moving fast.##train,car	গাড়ি দ্রুত এগিয়ে চলেছে।
block wall behind giraffe head##giraffe,giraffe,giraffe	জিরাফ মাথার পিছনে প্রাচীর ব্লক
yellow stand##bus,car,person,person,car,car,person,person,handbag,car	হলুদ স্ট্যান্ড
chinese characters are in the sign##	চীনা অক্ষর চিহ্ন আছে
the seat of the second motorcycle##motorcycle,motorcycle	দ্বিতীয় মোটরসাইকেলের সিট
Green part of a tennis court.##person,tennis racket	টেনিস কোর্টের সবুজ অংশ।
the wave moves fast##person,surfboard	তরঙ্গ দ্রুত চলে আসে
White second hand on the clock.##clock,person	ঘড়িতে সাদা সেকেন্ডের কাঁটা
green colored material separating the court##person,person,person,person,person,person,person,person,tennis racket,person	সবুজ রঙের জিনিস দিয়ে কোর্টটি আলাদা করা আছে
The traffic lights stand out a lot.##person,traffic light,car,car,traffic light,person,traffic light,car,person,car	অনেকগুলো ট্রাফিক লাইট
fine stitching on leash##dog	চেন এর উপর সূক্ষ্ম সেলাই
Kick stand on a motorcycle.##motorcycle,person,traffic light,traffic light,car,car,car,person,motorcycle,fire hydrant	একটি মোটরসাইকেলের কিকস্টান্ড
An electronic display showing the date##clock,tv	একটি বৈদ্যুতিন প্রদর্শন তারিখটি দেখায়
cement block facade on a building##person,person,cell phone	একটি বিল্ডিং সিমেন্ট ব্লক সম্মুখের
person forces cow to ramble over rocks for unknown reason##cow,person,baseball bat	ব্যক্তি অজানা কারণে গাভীকে পাথরের উপরে চলাফেরা করতে বাধ্য করে
a cross walk across street white pattern##fire hydrant,car,car,car,car,car,car,car,car,car	রাস্তার সাদা প্যাটার্ন জুড়ে ক্রস ওয়াক
two lemons together on a block##orange,orange,potted plant,oven,dining table,oven,cup,broccoli	একটি ব্লকে দুটি লেবু একসাথে
white teeth-like forms on top of wing##airplane,car	ডানা উপরে সাদা দাঁত মত ফর্ম
date in red letters and numerals##umbrella,clock,potted plant,clock,umbrella,potted plant,potted plant,potted plant,clock	লাল বর্ণ এবং সংখ্যাগুলিতে তারিখ
empire near second base##person,person,baseball bat,person,baseball glove,tie,tie	দ্বিতীয় বেস কাছাকাছি সাম্রাজ্য
second place is wearing yellow##person,sheep,sheep,umbrella,sheep,dog,teddy bear,person,dog,person	দ্বিতীয় স্থান হলুদ পরা হয়
man in the middle of tennis court##person	টেনিস কোর্টের মাঝখানে মানুষ
The second sign says 4 way.##stop sign,stop sign	দ্বিতীয় চিহ্নটি 4 উপায় বলে।
five wheels on the court##person,person,bicycle,person,bicycle,person,chair,person,person,remote	কোর্টে পাঁচ চাকা
Red T-shirt with white cross patch##person,tennis racket,sports ball,person,person,person,person,person,person,person	সাদা ক্রস প্যাচ সহ লাল টি-শার্ট
small white rocking chair with mother and child models in it##person,person,person,person,person,person,person,person,boat,person	এতে মা ও শিশুদের মডেল সহ ছোট ছোট দোলের চেয়ার
The comb is fine toothed.##person,person,person	চিরুনিটি দাঁতযুক্ত is
date stamp on the photo##person,person,airplane,person,person,person,person,person,person,person	ছবির উপর তারিখ স্ট্যাম্প
Chinese characters on the sign##person,person,remote,chair,laptop,chair,chair,laptop	সাইন ইন চীনা অক্ষর
The sky is fair.##bicycle,bench,bench,bottle,boat,bicycle,boat,boat,boat,bottle	আকাশটা ফর্সা।
a green court##person,tennis racket,sports ball	সবুজ কোর্ট
a woman walking throw a trade fair##person,toilet,person,sink,refrigerator,laptop,cup,person,person	একজন মহিলা হাঁটছেন একটি বাণিজ্য মেলা
A crowd of people standing at the fair.##person,person,kite,person,kite,kite,umbrella,person,person,person	মেলায় দাঁড়িয়ে মানুষের ভিড়।
a man standing on court##person,person,person,sports ball,bicycle	একজন লোক কোর্টে দাঁড়িয়ে
cross on a building##bird,bird,bird,bird,bird,bird	একটি বিল্ডিং উপর ক্রস
the players shoes have spikes##person,person,person,person,baseball bat,person,person,person,person,person	প্লেয়ার জুতা স্পাইক আছে
A large brown block.##person,car,person,person,skateboard,dog,car,person,person,car	একটি বড় বাদামী ব্লক।
Man skiing fast##person,person,person,person,person,skis,person,person,person,skis	ম্যান দ্রুত স্কিইং
the person has fair skin##remote,keyboard,keyboard,person,keyboard	ব্যক্তির ফর্সা ত্বক আছে
Skid foot marks on a tennis court##person,tennis racket,sports ball	টেনিস কোর্টে স্কিড পায়ের চিহ্ন
a woman in a fair isle sweater##person,bottle,bottle,cake,oven,bottle,bottle,cake,bottle,bottle	ফর্সা আইল সোয়েটারের এক মহিলা
Shadow on the ground of the second racket from the left##person,person,sports ball,person,tennis racket,person,person,person,person,person	বাম দিক থেকে দ্বিতীয় র‌্যাকেটের মাটিতে ছায়া
A backwards baseball hat on the players head.##person,tennis racket,sports ball	খেলোয়াড়দের মাথার পিছনে একটি বেসবল টুপি।
a watermark and date##person,surfboard	একটি জলছবি এবং তারিখ
the toys are on the stand##tv,couch,suitcase,tv,dining table,vase	খেলনা স্ট্যান্ডে আছে
a second statue of a cow##cow,cow	একটি গরুর দ্বিতীয় মূর্তি
large crack in tennis court##person,person,tennis racket,tennis racket,car	টেনিস কোর্টে বড় ফাটল
The white ice models in the room.##bear	ঘরে সাদা বরফের মডেল।
hairy arm with fair pale skin##person,refrigerator,truck,truck	ফর্সা ফ্যাকাশে ত্বক সঙ্গে লোমশ বাহু
Paper on night stand##bed,chair,couch,cup	নাইট স্ট্যান্ডে কাগজ
date stamp that reads 12/04/2010##truck,truck,person,truck,truck,truck,person	তারিখ স্ট্যাম্প যা 12/04/2010 পড়বে
Yellow criss cross on the street by train.##train,traffic light,train,person,train,car,car,traffic light	ট্রেনে রাস্তায় হলুদ ক্রাইসস অতিক্রম করে।
base ball opponent players##person,person,person,baseball bat,person,person,person,baseball glove,person,person	বেস বল প্রতিপক্ষের খেলোয়াড়
three baseball players playing a game##person,person,person,person,baseball glove,person,person,baseball bat,person,person	তিনটি বেসবল খেলোয়াড় একটি খেলা খেলছে
The white bins on the second shelf of the fridge.##chair,refrigerator,bowl,bottle,microwave,bottle	ফ্রিজের দ্বিতীয় তাকের সাদা পাতাগুলি।
fine texture of feathers##bird	পালকের সূক্ষ্ম জমিন
large orange and green sign giving name and date##motorcycle,person,motorcycle,person,motorcycle,truck,car,car,motorcycle,motorcycle	নাম এবং তারিখ প্রদত্ত বড় কমলা এবং সবুজ চিহ্ন
green cross on top of building##	বিল্ডিংয়ের উপরে সবুজ ক্রস
colorful bus parked next to a stand and umbrella##bus,person,umbrella,person,umbrella,person,person,person,person	স্ট্যান্ড এবং ছাতার পাশেই পার্কিং রঙিন বাস
a purple umbrella with little cartoon characters##umbrella,person,person	ছোট্ট কার্টুন চরিত্র সহ একটি বেগুনি ছাতা
the date is shown on the outter portion##clock	তারিখটি বহির্মুখী অংশে প্রদর্শিত হয়
fast moving ball towards home plate##person,person,sports ball,baseball glove	হোম প্লেটের দিকে দ্রুত চলমান বল
a fast food ordering bar##person,person,person,person,person,person,person,person,handbag,person	একটি ফাস্ট ফুড অর্ডার বার
The date 02/10/2009.##knife,person,carrot,carrot,knife,carrot,dining table	তারিখ 02/10/2009।
train going by fast##person,train,bench,person	দ্রুত যেতে ট্রেন
date and time stamp##keyboard,dining table	তারিখ এবং সময় স্ট্যাম্প
person has fair colored skin##horse,person,dog	ব্যক্তির ফর্সা বর্ণের ত্বক থাকে
the copyright stamp on the photo##person,sports ball,tennis racket,tennis racket	ছবির কপিরাইট স্ট্যাম্প
grey fine toothed comb##scissors,toothbrush,scissors,scissors	ধূসর জরিমানা দাঁতযুক্ত ঝুঁটি
pizza on a butcher block table##cup,pizza,pizza,broccoli	কসাই ব্লক টেবিলে পিজ্জা
gold Chinese characters on a red flag##traffic light,tv	একটি লাল পতাকায় স্বর্ণের চীনা অক্ষর
The date stamp on the photo.##	ছবির উপর তারিখ স্ট্যাম্প।
red and white cross on man's shoulder##person,cow,baseball glove,cow	মানুষের কাঁধে লাল এবং সাদা ক্রস
second bird is standing on car##bird,bird,person,person,car,car	দ্বিতীয় পাখি গাড়িতে দাঁড়িয়ে আছে
white lines painted on court##person,person,person,person,clock,person,person,person,person,tennis racket	সাদা লাইন কোর্টে আঁকা
A tennis court has snow on the surface##person	একটি টেনিস কোর্টের তলদেশে বরফ রয়েছে
a metal stand under the seat of a bench##refrigerator,bench,suitcase,chair	একটি বেঞ্চের সিটের নীচে একটি ধাতব স্ট্যান্ড
a railing forms a corner sitting area##suitcase,chair,clock,bed,person	একটি রেলিং কোণার বসার অঞ্চল গঠন করে
boy sitting cross-legged on ground##person,person,person,person,person,person,baseball bat,baseball bat,person,person	ছেলেটি মাটিতে ক্রস লেগে বসে আছে
date and hotel that the photo was taken##teddy bear,cake,person,person,person,dining table	তারিখ এবং হোটেল যে ছবি তোলা হয়েছিল
fine china with flower design##person,wine glass,person,spoon,spoon,knife,dining table,chair,chair,spoon	ফুলের নকশা সহ সূক্ষ্ম চীন
green field next to players##person,person,person,baseball glove	খেলোয়াড়দের পাশে সবুজ ক্ষেত্র
black metal cross-walk light##traffic light,car,traffic light,traffic light	কালো ধাতব ক্রস ওয়াক আলো
a lone spectator behind the tennis players##person,person,person,person,person,person,person,person,person,person	টেনিস খেলোয়াড়দের পিছনে একাকী দর্শক
the picture has a date stamp##keyboard,tv,book,book	ছবিটিতে একটি তারিখের স্ট্যাম্প রয়েছে
Calendar has star wars characters on it##keyboard,chair,tv,mouse,tv,cup,book,book,book,book	ক্যালেন্ডারে এতে তারকা যুদ্ধের অক্ষর রয়েছে
spectator seats at a tennis court##person,tennis racket	টেনিস কোর্টে দর্শকের আসন
a hard true tennis court##person,sports ball,tennis racket	একটি কঠিন সত্য টেনিস কোর্ট
Grate over a concrete block##banana,person,banana,banana	একটি কংক্রিট ব্লকের উপর কষান
foreign characters on the vehicle's side##train,bus,person,bird	গাড়ির পাশে বিদেশী অক্ষর
wood platform for bird to stand on##bird,person,clock	পাখি দাঁড়িয়ে জন্য কাঠের প্ল্যাটফর্ম
Woman going fast downhill.##person,skis	মহিলা দ্রুত উতরাইয়ের দিকে যাচ্ছে।
second floor windows##bus,person,person,car,person,person,person,person,person,person	দ্বিতীয় তলার জানালা
second red and blue train##train,train,train,train,train,train,person,car,train,car	দ্বিতীয় লাল এবং নীল ট্রেন
White lamp shade on tall stand##tv,cat,couch,couch,bowl	লম্বা স্ট্যান্ডে সাদা ল্যাম্প শেড
fast pass tickets on bus window##bus	বাসের জানালায় দ্রুত পাসের টিকিট
an english style toilet##sink,traffic light,toilet,bottle,traffic light,sink,toilet,cup,bottle,cake	একটি ইংরেজি স্টাইল টয়লেট
Large models in the park field##person,person,kite,kite,person,person,person,person,person,kite	পার্ক মাঠে বড় মডেল
chair is decorated with Disney characters##cup,person,bowl,bottle,spoon,dining table,dining table,potted plant	চেয়ার ডিজনি অক্ষর সজ্জিত
knife on the chopping block##person,person,knife,knife,bowl,bottle,oven,oven,oven,bottle	কাটা ব্লকের উপর ছুরি
A bed of steel springs##toilet	স্টিলের ঝর্ণার একটি বিছানা
this is a fast food place##person,person,chair,chair,dining table,chair,dining table,microwave,chair,bottle	এটি একটি ফাস্ট ফুডের জায়গা
beige table lamp on stand##person,suitcase,book,cat,book,book,chair,chair,bed,bed	স্ট্যান্ডে বেইজ টেবিল ল্যাম্প
the tennis court##person,person,person,person,person,person,tennis racket,chair,person,chair	টেনিস কোর্ট
trunk of elephant forms a C##elephant,zebra,zebra,zebra,zebra,zebra,zebra,zebra,zebra,zebra	হাতির ট্রাঙ্ক একটি সি গঠন করে
food on english muffin with yellow sauce##fork,orange,cake,cup,sandwich,dining table,cake,cup	হলুদ সসের সাথে ইংলিশ মাফিনে খাবার
This part of the court is blue##person,chair,person,person,person,person,person,person,person,person	কোর্টের এই অংশটি নীল
an attraction for a fair##motorcycle	একটি মেলা জন্য আকর্ষণ
blue box on tennis court##person,tennis racket,sports ball	টেনিস কোর্টে ব্লু বক্স
black metal plant stand##person,potted plant,couch,knife	কালো ধাতব উদ্ভিদ স্ট্যান্ড
the players hanging out in the dugout##person,person,person,person,person,bench,person,person,person,bench	খেলোয়াড়রা হতাশায় ঝুলছে
Base of the yellow umbrella second from the left##umbrella,umbrella,umbrella,umbrella,umbrella,umbrella,umbrella,umbrella,umbrella,umbrella	বাম থেকে দ্বিতীয় হলুদ ছাতা বেস
the black fast forward arrow##person,couch,cell phone	কালো দ্রুত এগিয়ে তীর
Orange color night lamp with wooden stand##person,book,remote,book,book,book,book,book,book,book	কাঠের স্ট্যান্ড সহ কমলা রঙের নাইট ল্যাম্প
line where block fit together##person,traffic light,traffic light,tv	ব্লক যেখানে একসাথে ফিট
bat stand in middle of bats##person,bottle,person,baseball bat,person,baseball bat,person,person,baseball bat,baseball bat	ব্যাট ব্যাট এর মাঝখানে
doilee stand is silver##cake,cake,cake,cake,cake,cake,cake,cake,cake,cake	দোয়েলি স্ট্যান্ড সিলভার is
person on the court wearing black shirt##person,person,person,tennis racket,person,person,person,person,person,person	কোর্টে কালো শার্ট পরা ব্যক্তি
different plane models are seen.##airplane,airplane,airplane,airplane,airplane,airplane,airplane,airplane,person,airplane	বিভিন্ন বিমানের মডেল দেখা যায়।
Two press buttons of the sweater##person,toothbrush	সোয়েটারের দুটি প্রেস বোতাম
Time and date stamp in corner##refrigerator,oven,microwave,knife,knife,knife,knife,knife,knife,knife	কোণে সময় এবং তারিখ স্ট্যাম্প
The stand of the t.v.##tv,person,bottle,book,book,book,book,book,book,book	T.v. এর স্ট্যান্ড
sharp knife on the chopping block##pizza,person,cup,wine glass,dining table,cup,bottle,dining table	কাটা ব্লকের উপর ধারালো ছুরি
second bird on right##bird,bird,bird	ডানদিকে দ্বিতীয় পাখি
woman wearing dress about to cross street##person,clock,person,fire hydrant,car,person,car,car,car,car	রাস্তায় পার হওয়ার জন্য পোশাক পরা মহিলা
two motor cycle springs##person,motorcycle	দুটি মোটর চক্র স্প্রিংস
a lava lamp on stand##person,tv,remote,bottle,chair,suitcase,book,book,couch,chair	স্ট্যান্ডে একটি লাভা বাতি
black springs##bird,bicycle,surfboard	কালো ঝর্ণা
a mirror on a stand##sink,refrigerator,bowl,chair	একটি স্ট্যান্ডে একটি আয়না
green grass as tennis court##person,sports ball,tennis racket,person,person,person	টেনিস কোর্ট হিসাবে সবুজ ঘাস
antique golf clubs and stand##suitcase,suitcase,suitcase,suitcase,suitcase,suitcase,suitcase,vase,suitcase	প্রাচীন গল্ফ ক্লাব এবং স্ট্যান্ড
wheels of train with springs##train,train	স্প্রিংস সঙ্গে ট্রেন চাকা
clear plastic French press##oven,microwave,refrigerator,chair,cup,cup,cup,vase	পরিষ্কার প্লাস্টিক ফ্রেঞ্চ প্রেস
fine brown dirt##person,person,person,person,person,person,person,person,person,person	সূক্ষ্ম বাদামী ময়লা
lifeguard stand is blue and white##truck,person	লাইফগার্ড স্ট্যান্ড নীল এবং সাদা
fast food##person,person,hot dog,person,person	ফাস্ট ফুড
a red cross on the paper##cat,refrigerator,book,cup,book,toothbrush,book	কাগজে একটি রেড ক্রস
a fast food meal served on a white plate##fork,person,sandwich,dining table,sandwich,hot dog,knife,knife,dining table,knife	একটি ফাস্ট প্লেট একটি সাদা প্লেটে পরিবেশন করা
Dirt is on the baseball players outfit##person,person,person,person,person,person,person,person,person,car	গ্লাসটি বেসবল খেলোয়াড়দের পোশাকে রয়েছে
A cinder block wall.##person,sheep,person,sheep,person,sheep,person,sheep,sheep,sheep	একটি সিন্ডার ব্লক প্রাচীর।
Man playing tennis on purple and green tennis court.##person,tennis racket,person,person,person,person,tennis racket,sports ball,tennis racket	ম্যান বেগুনি এবং সবুজ টেনিস কোর্টে টেনিস খেলছেন।
Cartoon characters on his shirt##person,bird,frisbee,clock,car,dining table,bench,bench	তার শার্টে কার্টুন চরিত্রগুলি
black TV stand with flat screen##chair,chair,chair,potted plant,couch,chair,vase,chair,couch,chair	ফ্ল্যাট পর্দা সঙ্গে কালো টিভি স্ট্যান্ড
Some people are at the county fair##person,person,person,person,person,person,kite,person,kite,person	কিছু লোক কাউন্টি মেলায় আছেন
charger stand on a desk##keyboard,laptop,keyboard,keyboard	চার্জার একটি ডেস্ক স্ট্যান্ড
security forces vehicle with open windows##person,airplane,person,person	নিরাপত্তা বাহিনী খোলা জানালা দিয়ে যানবাহন
Staircase leading to the second floor##chair,potted plant,chair,couch,couch,potted plant,wine glass,chair	সিঁড়ি দ্বিতীয় তলায় এগিয়ে
a stand of snow covered trees##person,person,person,backpack,skis,snowboard,backpack,skis,backpack	বরফ ঢাকা গাছের একটি স্ট্যান্ড
Three different cellphone models##cell phone,cell phone,dining table,chair,bowl,chair,chair,cell phone,person,dining table	তিনটি পৃথক সেলফোন মডেল
this is the cross##	এই ক্রস হয়
hedge bush growing outside of the tennis court##person,tennis racket	টেনিস কোর্টের বাইরে হেজ বুশ বাড়ছে
a fine skateboard##person,skateboard,person	একটি দুর্দান্ত স্কেটবোর্ড
the trees in the tennis court##person,person,tennis racket,sports ball,sports ball,sports ball,tennis racket,sports ball,sports ball,sports ball	টেনিস কোর্টে গাছ
wood cross##bench,potted plant,bench,bench,bench,bench,bench,bench,bench,bench	কাঠ ক্রস
a knife block on the shelf##bottle,chair,knife,bottle,chair,chair,knife,bowl,bottle,dining table	বালুচর উপর একটি ছুরি ব্লক
line of trees to the left of the court##person,person,person,person,tennis racket,person,person,person,person,person	কোর্টের বামে গাছের লাইন
surfer stand a surfboard##person,dog,person,surfboard,surfboard	surfer একটি surfboard স্ট্যান্ড
date book with plastic cover##car	প্লাস্টিকের কভার সহ তারিখের বই
a stamp in the wood##baseball bat,baseball bat	কাঠ একটি স্ট্যাম্প
yellow time and date stamp##person,person,person,person,person,person,person,person,person,bench	হলুদ সময় এবং তারিখ স্ট্যাম্প
some kind of festival or fair##motorcycle,motorcycle,person,person,person,motorcycle,person,person,umbrella,umbrella	কোন এক উত্সব বা মেলা
gate/door to fence surrounding court##person,tennis racket,sports ball	দরজার আশেপাশে বেড়া দরজা / দরজা
The bench the players are sitting on.##person,person,bottle,tennis racket,person,person,person,tennis racket,tennis racket,person	খেলোয়াড়রা বসে আছেন বেঞ্চে।
Helmet on the second horse rider.##horse,horse,person,person,dog,horse,person	দ্বিতীয় ঘোড়সওয়ারে হেলমেট
poles that block entrance by large vehicles##clock,person,car	বড় বড় যানবাহন দিয়ে খুঁটিগুলি প্রবেশ পথ আটকে দেয়
black shadow on baseball field beneath baseball players feet##person,baseball glove	বেসবল খেলোয়াড়দের পায়ের নীচে বেসবল মাঠে কালো ছায়া
sign on brass stand##person,person,car,car,car,person,car,person,car,car	পেতলের স্ট্যান্ড এর উপর সাইন
Soccer players sitting on a bench##person,sports ball,person,person,person,person,person,person,person,person	একটি বেঞ্চে বসে সকার খেলোয়াড়রা
the second hand of the clock##clock,fork,scissors	ঘড়ির সেকেন্ডের কাঁটা
A girl on the tennis court is preparing to hit the ball##person,tennis racket,sports ball,baseball bat,sports ball,sports ball,sports ball,sports ball,sports ball	টেনিস কোর্টের একটি মেয়ে বলটি মারার প্রস্তুতি নিচ্ছে
brick building on a city block##car,person,person,person,person,train,person,person,person,person	একটি শহর ব্লকে ইট নির্মাণ
foul lines marking the court##person,tennis racket,person,person,person,person	ফাউল লাইন দিয়ে কোর্টে দাগ টানা
A large screen with information about the players.##person,tennis racket,person,person,person,person,person,person,person,chair	খেলোয়াড়দের সম্পর্কে তথ্য সহ একটি বড় পর্দা।
part of a tennis court##person,sports ball,chair,baseball bat	একটি টেনিস কোর্ট অংশ
baseball players shoe##person,person,baseball bat,sports ball,baseball bat,person,baseball glove,baseball bat,baseball glove	বেসবল খেলোয়াড় জুতো
a golden stand for the tub##sink,sink	টব জন্য একটি সোনার স্ট্যান্ড
the trains are toy models##train,clock,suitcase,train	ট্রেনগুলি খেলনা মডেল
baseball bat in players hands##person,person,person,baseball glove,person,person,person,person,person,person	খেলোয়াড়দের হাতে বেসবল ব্যাট
person in black with a camera at the side of the court##person,person,tennis racket,sports ball,person,person,person,person,person,person	কোর্টের পাশে ক্যামেরা সহ কালো রঙের ব্যক্তি
press type electric cooking grill##chair,oven,bottle,chair,sink,bottle,dining table,bottle,bottle,potted plant	বৈদ্যুতিন রান্না গ্রিল প্রেস
Award for state fair pears##apple,apple,apple,dining table,apple,apple,bowl,orange,bowl,orange	রাজ্য মেলা নাশপাতি জন্য পুরষ্কার
players shorts are red##person,tennis racket,baseball glove	খেলোয়াড়দের হাফপ্যান্টগুলি লাল
The sole of a second green shoe.##suitcase,person,cup,skateboard,fire hydrant,knife	দ্বিতীয় সবুজ জুতা একক।
the players uniform is green and white##person,tennis racket	খেলোয়াড়দের ইউনিফর্ম সবুজ এবং সাদা
The yellow vase on the second shelf on the right.##bottle,bottle,bottle,bottle,bottle,vase,vase,bottle,bottle,wine glass	ডানদিকে দ্বিতীয় তাকের হলুদ দানি।
a group of game officials at the corner of tennis court##person,person,person,person,tennis racket,person,person,person,person,handbag	টেনিস কোর্টের এক কোণে গেমের এক আধিকারিক
large patch of grass next to fast food restaurant##car,umbrella,car,stop sign,car,car,stop sign,car,car	ফাস্ট ফুড রেস্তোরাঁয়ের পাশে ঘাসের বড় প্যাচ
Silver springs on the side of bike.##motorcycle,tie,person	সাইকেলের পাশে সিলভার স্প্রিংস।
White copyright stamp##person,skateboard	সাদা কপিরাইট স্ট্যাম্প
the word front on the sign in the english section##person,book	ইংরেজি বিভাগে সাইন ইন শব্দটি সামনে
Chinese characters on the window##person,bowl,bowl,bowl,cup,person,person,bottle,cup,person	উইন্ডোতে চীনা অক্ষর
wide brown night stand##bed,potted plant,potted plant,bench,vase,chair,vase,vase	প্রশস্ত ব্রাউন নাইট স্ট্যান্ড
cartoon characters on the bottle##person,chair,dining table,donut,book,backpack,suitcase,handbag,book,chair	বোতল উপর কার্টুন অক্ষর
top glass block in wall##sink,bottle	দেয়ালে শীর্ষ গ্লাস ব্লক
A stand with devices on it and wires behind it.##bowl,chair,couch,dining table,book,tv,book,book,book,book	এটিতে থাকা ডিভাইস এবং এর পিছনে তারযুক্ত একটি স্ট্যান্ড।
Several forms of public transportation##person,train,bicycle,bus,car,person,person,train,train,bus	গণপরিবহন বিভিন্ন ধরণের
second skateboard in picture##skateboard,person,person,person,tv,chair,skateboard,person,skateboard,bench	ছবিতে দ্বিতীয় স্কেটবোর্ড
really fast moving hand##person,person,potted plant,chair,chair,remote,remote,remote,person,chair	সত্যিই দ্রুত চলন্ত হাত
blue television on stand##chair,tv,bowl,dining table,chair,dining table,couch,dining table,bottle,vase	স্ট্যান্ড নীল টেলিভিশন
The stand in the background with products the color white.##orange,orange,orange,orange,orange,orange,orange,orange,orange,orange	সাদা রঙের পণ্যগুলির সাথে পটভূমিতে স্ট্যান্ড।
A big tv on a stand##couch,tv,chair,vase,potted plant,chair,dining table,chair,clock,dining table	স্ট্যান্ডে একটি বড় টিভি
group of cross country skiers##person,skis,person,person,backpack,person,snowboard	ক্রস কান্ট্রি স্কিয়ার গ্রুপ
Screen of second laptop on desk##vase,chair,potted plant,vase,tv,laptop,laptop,chair,tv	ডেস্কে দ্বিতীয় ল্যাপটপের স্ক্রিন
A time stamp##banana,banana,surfboard,banana,banana,banana,banana	একটি সময় স্ট্যাম্প
computer monitor on stand##keyboard,laptop,tv,keyboard,cup,mouse,person,book,keyboard,handbag	স্ট্যান্ডে কম্পিউটার মনিটর
white forms on a keyboard##tv,tv,mouse,potted plant,book,person,keyboard,book,book,book	একটি কীবোর্ডে সাদা ফর্ম
the court is made of sand##	কোর্ট বালু দিয়ে তৈরি
stone block building side##toilet	পাথর ব্লক বিল্ডিং পাশ
fence around the court.##person,tennis racket,person,person,person,tennis racket,person,tennis racket,sports ball,bench	কোর্টের চারপাশে বেড়া
Blue scooter kick stand##person,person,motorcycle,motorcycle,motorcycle,chair,motorcycle	ব্লু স্কুটার কিক স্ট্যান্ড
small patch of grass beside a tennis court##person,tennis racket,sports ball	টেনিস কোর্টের পাশে ঘাসের ছোট প্যাচ
a fence between the field and players##person,person,baseball bat,person,person,baseball bat,baseball bat,person,person,person	মাঠ এবং খেলোয়াড়দের মধ্যে একটি বেড়া
Sponsor signs hanging on the walls of the tennis court.##person,tennis racket	টেনিস কোর্টের দেয়ালে ঝুলন্ত স্পনসর লক্ষণ।
Many stairs up to a second story.##motorcycle,chair,person	অনেকগুলি সিঁড়ি দ্বিতীয় তলা পর্যন্ত।
section of fine gray sand##person,surfboard,surfboard	সূক্ষ্ম ধূসর বালির বিভাগ
Blue, yellow and white stripes on players uniform.##person,person,tennis racket,person,person,person,person,person,person,person	খেলোয়াড়দের ইউনিফর্মে নীল, হলুদ এবং সাদা ফিতে।
