en	bn
a bunch of books on book stand	বইয়ের স্ট্যান্ডে একগুচ্ছ বই
gold religious cross on top of golden ball	সোনার বলের উপরে সোনার ধর্মীয় ক্রস
Candle on glass candle stand	গ্লাস মোমবাতি স্ট্যান্ডে মোমবাতি
a blue wall beside tennis court	টেনিস কোর্টের পাশে একটি নীল প্রাচীর
fine thin red hair	সূক্ষ্ম পাতলা লাল চুল
front springs of motocross motorcycle	মোটরক্রস মোটরসাইকেলের সামনের স্প্রিংস
the tennis court is made up of sand and dirt	টেনিস কোর্ট বালু এবং ময়লা দিয়ে গঠিত
court attendant sitting in chair	চেয়ারে বসে কোর্ট অ্যাটেন্ডেন্ট
a cross on the top of a spire	একটি বীর্যের শীর্ষে একটি ক্রস
the cross is black	ক্রস কালো হয়
press box on tennis court	টেনিস কোর্টে প্রেস বক্স
the characters are chinese	চরিত্রগুলি চীনা
date and time of photo	তারিখ এবং ছবির সময়
Luggage sign in english and spanish	লাগেজ সাইন ইন ইংলিশ এবং স্প্যানিশ
box springs on bottom of bed	বিছানার নীচে বক্স স্প্রিংস
box springs with flower print	ফুলের মুদ্রণ সহ বক্স স্প্রিংস
fork under english muffin	ইংরেজি মাফিনের নীচে কাঁটাচামচ
there are two players in the court	কোর্টে দুজন খেলোয়াড় আছেন
a man trying to cross	একজন লোক ক্রস করার চেষ্টা করছে
people on the second level	দ্বিতীয় স্তরের লোকেরা
Name and date stamp on picture	ছবিতে নাম এবং তারিখের স্ট্যাম্প
A stand of trees.	গাছের একটি স্ট্যান্ড।
umbrella to block sun	ছাতা রোদে ব্লক করতে
the woman is waiting to cross the street	মহিলা রাস্তায় পারাপারের জন্য অপেক্ষা করছেন
the lady appears to be going cross country skiing	ভদ্রমহিলা মনে হয় ক্রস কান্ট্রি স্কিইং যাচ্ছেন
White candle on a stand	একটি স্ট্যান্ডে সাদা মোমবাতি
A grey rock wall forms a boundary of the enclosure	একটি ধূসর শিলা প্রাচীর ঘেরের সীমানা গঠন করে
a large block entrance	একটি বড় ব্লক প্রবেশদ্বার
date when taken in yellow	তারিখ যখন হলুদ নেওয়া হয়
tail of cat forms a C	বিড়ালের লেজ একটি সি গঠন করে
Wooden railing on second level	দ্বিতীয় স্তরে কাঠের রেলিং
white springs boxes and gears below train engine	ট্রেন ইঞ্জিনের নীচে সাদা স্প্রিংস বক্স এবং গিয়ার
time and date stamp on the photograph	ছবিতে সময় এবং তারিখের স্ট্যাম্প
yellow fair pole on fence	বেড়া উপর হলুদ ফর্সা খুঁটি
baseball players dressed in gray and orange	বেসবল প্লেয়াররা ধূসর এবং কমলা রঙের পোশাক পরা
teal sign with white asian characters	সাদা এশিয়ান অক্ষরগুলির সাথে টিল সাইন
Chain-link enclosure for tennis court	টেনিস কোর্টের জন্য চেইন-লিংক ঘের
stand in the room	রুমে দাঁড়ানো
The window on the right on the second floor.	দ্বিতীয় তলায় ডানদিকে উইন্ডো।
Date stamp of photograph	ফটোগ্রাফের তারিখ স্ট্যাম্প
large silver juice press	বড় রূপোর জুস প্রেস
the players in the dugout	খেলোয়াড়দের ডাগআউট
A white pot on the stand	স্ট্যান্ডে একটি সাদা পাত্র
Photo's date stamp.	ছবির তারিখ স্ট্যাম্প।
hind leg forms one quadrant	পেছনের লেগ এক চতুর্ভুজ গঠন
Light green tennis court	হালকা সবুজ টেনিস কোর্ট
soccer players red shirt	ফুটবল খেলোয়াড়রা লাল শার্ট
Gray television on stand	স্ট্যান্ড ধূসর টেলিভিশন
a second meal plate.	দ্বিতীয় খাবারের প্লেট
dark wooden wash stand	গাঢ় কাঠের ওয়াশ স্ট্যান্ড
Cube-like cement block out-building with large square door	বড় স্কোয়ারের দরজা সহ কিউব-জাতীয় সিমেন্ট ব্লক আউট বিল্ডিং
chinese characters on a red vehicle	একটি লাল গাড়িতে চীনা অক্ষর
blue tennis court area	নীল টেনিস কোর্ট অঞ্চল
Cement block outdoor flooring.	সিমেন্ট ব্লক আউটডোর মেঝে
the sign has asian characters	সাইন এশিয়ান অক্ষর আছে
a cross sign on top of the tower	টাওয়ারের উপরে একটি ক্রস চিহ্ন
man is waiting to cross	মানুষ ক্রস করার জন্য অপেক্ষা করছে
spikes on a players shoe	একটি প্লেয়ার জুতো উপর কাঁটা
a museum containing models of airplanes	বিমানগুলির মডেল সমন্বিত একটি যাদুঘর
date and time stamp on a picture	একটি ছবিতে তারিখ এবং সময় স্ট্যাম্প
Chinese characters on sign	সাইন ইন চীনা অক্ষর
an orange sign with written characters	লিখিত অক্ষরের সাথে একটি কমলা চিহ্ন
Baseball players are in the background	বেসবল প্লেয়াররা পটভূমিতে রয়েছে
Newspaper stand on the grass	খবরের কাগজ ঘাসে দাঁড়িয়ে আছে
young female date wearing a purple rhinestone sleeveless gown	বেগুনি কাঁচের কাঁচের স্লিভলেস গাউন পরা তরুণ মহিলা তারিখ 
two people waiting to cross	দুই জন ক্রস করার জন্য অপেক্ষা করছে
the side of the second train	দ্বিতীয় ট্রেনের পাশ
the bird is stand on a tree branch	পাখি গাছের ডালে দাঁড়িয়ে আছে
a black cross on a vertical stabilizer	একটি উল্লম্ব স্ট্যাবিলাইজারের উপর একটি কালো ক্রস
a green tennis court	একটি সবুজ টেনিস কোর্ট
neutral makeup on both rain models	উভয় বৃষ্টি মডেল নিরপেক্ষ মেকআপ
the second bus has a blue sign	দ্বিতীয় বাসটিতে একটি নীল চিহ্ন রয়েছে
This is some type of a fair.	এটি মেলার এক প্রকার।
A display of different phone models	বিভিন্ন ফোনের মডেলগুলির প্রদর্শন
microphone on the court	কোর্টে মাইক্রোফোন
person doing a hand stand	ব্যক্তি একটি হাত স্ট্যান্ড করছেন
springs of the seat	আসন স্প্রিংস
A large pipe extending from the wall of the court.	কোর্টের দেয়াল থেকে প্রসারিত একটি বৃহত পাইপ।
rapid in fast water	দ্রুত জলে দ্রুত
a stone block train platform	একটি পাথর ব্লক ট্রেন প্ল্যাটফর্ম
a book is on the night stand	একটি বই নাইট স্ট্যান্ডে আছে
orange springs on the bottom of train	ট্রেনের নীচে কমলা ফোয়ারা
a fast flowing river	একটি দ্রুত প্রবাহিত নদী
lighted signs for different forms of public transportation	জনসাধারণের যাতায়াত বিভিন্ন ধরণের জন্য আলোকিত লক্ষণ
three windows on the second floor	দ্বিতীয় তলায় তিনটি জানালা
a dark blue sedan moving fast	গাঢ় নীল রঙের সেডান দ্রুত গতিতে চলছে
zebras stand close together to watch for predators	শিকারীরা দেখার জন্য জেব্রা একসাথে দাঁড়িয়ে আছে
Gated street fair	গেটেড স্ট্রিট মেলা
surfboard forms a splash of water	সার্ফবোর্ড জল স্প্ল্যাশ গঠন
paper triangle stand	কাগজের ত্রিভুজ স্ট্যান্ড
a time and date stamp	একটি সময় এবং তারিখ স্ট্যাম্প
english letter is white	ইংরেজি বর্ণ সাদা
Brown box is on the tennis court	ব্রাউন বক্স টেনিস কোর্টে রয়েছে
a cross is on the tower	একটি ক্রুশ টাওয়ারের উপরে রয়েছে
players in dirt circle	ময়লা বৃত্তের খেলোয়াড়
beige stair way going to second level	বেইজ সিঁড়ি উপায় দ্বিতীয় স্তরে যাচ্ছে
grey concrete cross by the building	বিল্ডিং দ্বারা ধূসর কংক্রিট ক্রস
block for bench feet	বেঞ্চ ফুট জন্য ব্লক
location characters are white	অবস্থানের অক্ষরগুলি সাদা
Brown plastic fast food table	ব্রাউন প্লাস্টিকের ফাস্ট ফুড টেবিল
The TV and stand in the living room	বসার ঘরে টিভি এবং স্ট্যান্ড
brown wooden stairs leading to second floor	বাদামি কাঠের সিঁড়ি দিয়ে দোতলা যাওয়া যায়
very fine fabric and material	খুব সূক্ষ্ম বুনন এবং কাপড়
do not block intersection sign is above the right lane must turn right sign	ছেদটি অবরোধ করবেন না সাইনটি ডান দিকেই যান সাইন এর উপরে আছে
The motorcycles are going fast	মোটর সাইকেলগুলো দ্রুত চলছে
a fence behind the players	খেলোয়াড়দের পিছনে একটি বেড়া
the date on the photo	ফটোর উপরে তারিখ
the penalty box is white lined	পেনাল্টি বক্সটি সাদা রেখা দ্বারা চিহ্নিত
the green sign with red and yellow characters	সবুজ সাইন এর মধ্যে লাল এবং হলুদ হরফ
A red metal frame forms the half pipe	একটি লাল ধাতব ফ্রেম দিয়ে অর্ধেক পাইপ টি তৈরী 
shadows of players on court	কোর্টে খেলোয়াড়দের ছায়া
a red tennis shoe on players foot	খেলোয়াড় এর পায়ে একটি লাল টেনিস জুতো
clock face on wall date	দেয়াল এর ঘড়িতে তারিখ 
a group of people watching the baseball players	বেসবল খেলোয়াড়দের দেখছেন একদল লোক
a woman on the opposite team trying to block the frisbee	বিপক্ষ দলের এক মহিলা ফ্রিসবি আটকানোর চেষ্টা করছেন 
a white stand on road	রাস্তায় একটি সাদা স্ট্যান্ড
Concrete forms in pavement	ফুটপাতে কংক্রিট ফর্ম
man standing next to fruit stand	মানুষটি ফল স্ট্যান্ড এর পাশে দাঁড়িয়ে 
A bed plastic stamp	বিছানাতে প্লাস্টিকের স্ট্যাম্প
girl showing cow at fair	মেলায় গরু দেখাচ্ছে মেয়ে
judge on side of court on blue platform	কোর্ট এর এক পাশে নীল প্লাটফর্ম এ বিচারক 
The top white cross.	শীর্ষ সাদা ক্রস।
Dirt on the players pants.	খেলোয়াড়দের প্যান্টের উপর ময়লা।
chain-linked fence behind players	খেলোয়াড়দের পেছনে চেইন-লিঙ্কযুক্ত বেড়া
White paper on a black stand	একটি কালো স্ট্যান্ড উপর সাদা কাগজ
March 7th is the date on the calendar	৭ই মার্চ ক্যালেন্ডারে তারিখ
Tray of white rice and english muffins	সাদা ভাত এবং ইংলিশ মাফিনের ট্রে
a iron stand on back	পিছনে একটি লোহার স্ট্যান্ড
red hat on baseball players head	বেসবল খেলোয়াড় এর মাথায় লাল টুপি 
black and white tennis court netting	টেনিস কোর্ট এর সাদা এবং কালো জালের বুনানি
second set of closed umbrellas	বন্ধ ছাতার দ্বিতীয় সেট 
Bright red semi-gloss block wall	উজ্জ্বল আধা মসৃন লাল দেয়াল ব্লক 
Three baseball players are in the field.	তিনজন বেসবল খেলোয়াড় মাঠে আছেন 
A block wall is behind the skate park	স্কেট পার্কের পিছনে একটি ব্লক প্রাচীর রয়েছে
tail fine view of a red plane	একটি লাল বিমানের লেজ সূক্ষ্ম দর্শন
a group of ball players practicing	একটি বল খেলোয়াড়দের দল অনুশীলন করছে 
a fine silver pocket watch	একটি সূক্ষ্ম রুপার পকেট ঘড়ি
the date stamp in the corner of the pic	ছবিটির কোণায় তারিখ স্ট্যাম্প
Red circle with white cross under right wing	ডান ডানা নীচে সাদা ক্রস সঙ্গে লাল বৃত্ত
a metal stand for the flowers	ফুলের জন্য একটি ধাতব স্ট্যান্ড
A light reflecting on a tie press.	একটি টাই প্রেসে আলো প্রতিফলিত হচ্ছে 
loose sediment forms on the rocks	পাথরের উপর আলগা পলি ফর্ম
the hand is going to press a button	হাত একটি বোতাম টিপতে যাচ্ছে
sign written in english and foreign language	ইংরেজি এবং বিদেশী ভাষায় লিখিত সাইন
yellow stamp date near bottom	নীচে কাছাকাছি হলুদ স্ট্যাম্প তারিখ
Street sign on a pole in english and chinese	একটি স্ট্যান্ডের উপরে ইংলিশ এবং চীনা ভাষায় একটি রাস্তার সাইন
an english muffin sandwich	একটি ইংরেজি মাফিন স্যান্ডউইচ
many utility cables cross over the street	অনেক ইউটিলিটি তারগুলি রাস্তায় অতিক্রম করে
block sneakers with green laces	সবুজ লেইস সঙ্গে স্নিকার ব্লক
Brown painted signature and date.	বাদামি স্বাক্ষর এবং তারিখ আঁকা।
woman is behind the white line of a tennis court	টেনিস কোর্টের সাদা লাইনের পিছনে মহিলা রয়েছেন
a sign showing cross streets	ক্রস রাস্তা দেখানো একটি চিহ্ন
farmer's market stand	কৃষকের বাজার স্ট্যান্ড
banana on the stand	স্ট্যান্ডে কলা
logo stamp on the door	লোগো স্ট্যাম্প দরজা
english breakfast tea text	ইংরেজী প্রাতঃরাশের চা পাঠ্য
Black bike seat with silver springs.	সিলভার স্প্রিংস সহ কালো সাইকেলের সিট।
white sign with blue asian characters on it	এটিতে নীল এশিয়ান অক্ষরগুলির সাথে সাদা চিহ্ন
Big springs on the bottom of train.	ট্রেনের নীচে বড় স্প্রিংস।
Small French coffee press.	ছোট ফরাসি কফি প্রেস।
Landline phone on the night stand	নাইট স্ট্যান্ডে ল্যান্ডলাইন ফোন
A tin container decorated with Star Wars characters and themes	স্টার ওয়ার্সের অক্ষর এবং থিম দিয়ে সজ্জিত একটি টিনের পাত্রে
The players shoes are black.	খেলোয়াড়দের জুতো কালো।
Sis car models on top of each other	একে অপরের শীর্ষে সিস কার মডেল
date of the recording	রেকর্ডিংয়ের তারিখ
a second pizza in a pan	একটি প্যানে দ্বিতীয় পিজ্জা
cross walk lines on street	রাস্তায় ক্রস ওয়াক লাইন
two man standing on a tennis court	টেনিস কোর্টে দাঁড়িয়ে দুই ব্যক্তি
Cell phone is in stand.	সেল ফোন দাঁড়িয়ে আছে।
Blue section of tennis court	টেনিস কোর্টের ব্লু বিভাগ
A white plate with english muffins	ইংলিশ মাফিনস সহ একটি সাদা প্লেট
A block in the wall.	দেয়ালে একটি ব্লক।
a red sign advertising a fun fair	একটি লাল চিহ্ন একটি মজার মেলার বিজ্ঞাপন
a cross on the front of a church	একটি গির্জার সামনে ক্রস
the fence covered in netting at the end of the court	কোর্টের শেষে জাল দিয়ে বেড়ানো ঢাকা বেড়া
Small section of baseline on a tennis court	টেনিস কোর্টে বেসলাইনের ছোট্ট বিভাগ
a platter of fine china	সূক্ষ্ম চীন একটি থালা
Grey cross on a green dome top.	সবুজ গম্বুজ শীর্ষে ধূসর ক্রস।
fading on the court	কোর্টে বিবর্ণ
The date 01/03/2008 in yellow.	হলুদে ০১/০৩/২০০৮ তারিখ।
information stamp on image	ছবিতে তথ্য স্ট্যাম্প
yellow safety tape at a tennis court	টেনিস কোর্টে হলুদ সুরক্ষা টেপ
Balconies on the second story of the buildings	বিল্ডিংগুলির দ্বিতীয় গল্পের উপর বালকনিগুলি
Shades of the second biker	দ্বিতীয় বাইকারের ছায়া
a small black entertainment stand	একটি ছোট কালো বিনোদন স্ট্যান্ড
thumb press into a doughnut	একটি ডোনাট মধ্যে থাম্ব প্রেস
The line on the tennis court is white.	টেনিস কোর্টের লাইনটি সাদা।
mini hi-fi on small stand	ছোট স্ট্যান্ডে মিনি হাই ফাই
two people stand next to the boat	দু'জন লোক নৌকার পাশে দাঁড়িয়ে
an english taxi cab is on the bridge	একটি ইংরেজী ট্যাক্সি ক্যাব ব্রিজের উপরে রয়েছে
white TV stand on floor	ফ্লোরে সাদা টিভি স্ট্যান্ড
cross that sits atop the column on the left side	বাম দিকে কলামের উপরে বসে যে ক্রস
Two baseball players at the plate	প্লেটে দুটি বেসবল খেলোয়াড়
photo date on right	ডানদিকে ছবির তারিখ
a fine meal on a plate	একটি প্লেটে একটি চমৎকার খাবার
a glass block window	একটি গ্লাস ব্লক উইন্ডো
time and date stamp on the picture	ছবিতে সময় এবং তারিখের স্ট্যাম্প
sing is written in chinese and latin characters	গান চীনা এবং লাতিন অক্ষরে লেখা হয়
fine, pale sand	ঠিক আছে, ফ্যাকাশে বালু
cone of plane appears dark, shiny and fast	সমতল শঙ্কু অন্ধকার, চকচকে এবং দ্রুত প্রদর্শিত হবে
round light gray large cement block	গোলাকার হালকা ধূসর বড় সিমেন্ট ব্লক
Large tv on black stand.	কালো স্ট্যান্ডে বড় টিভি।
soccer players connect chin and forehead	ফুটবল খেলোয়াড়রা চিবুক এবং কপাল সংযোগ করে
a round wooden block	একটি বৃত্তাকার কাঠের ব্লক
a juice press	একটি রস প্রেস
Railing on second floor of building	বিল্ডিংয়ের দ্বিতীয় তলায় রেলিং
white paper with pictures on stand on the table	টেবিলের উপর স্ট্যান্ডে ছবি সহ সাদা কাগজ
items for sale in stand	স্ট্যান্ড বিক্রয়ের জন্য আইটেম
ridged metal pole stand to a large clock	উত্তেজিত ধাতব মেরু একটি বড় ঘড়ির জন্য দাঁড়িয়ে
Silver metal monitor stand	সিলভার মেটাল মনিটর স্ট্যান্ড
Landscape shrub models on display	ডিসপ্লেতে ল্যান্ডস্কেপ গুল্ম মডেল
these are baseball players	এই বেসবল খেলোয়াড়
Cinder block base for fence	বেড়া জন্য সিন্ডার ব্লক বেস
A net in between the players	খেলোয়াড়দের মধ্যে একটি নেট
the blue 28 on the back of the players shirt	প্লেয়ারদের শার্টের পিছনে নীল 28
the second level of the bus	বাসের দ্বিতীয় স্তর
characters on the billboard	বিলবোর্ডে অক্ষর
The bolt underneath the springs.	ঝর্ণার নীচে বল্টু।
The net on a tennis court	টেনিস কোর্টে নেট
older dude on bicycle in a country where spanish/english are the official languages	এমন দেশে সাইকেলের উপর বয়স্ক ছেলেমেয়েরা স্প্যানিশ / ইংরেজি সরকারী ভাষা
Several models hanging in the air in the exhibit	প্রদর্শনীতে বাতাসে ঝুলন্ত বেশ কয়েকটি মডেল
black utensils in a wooden block	একটি কাঠের ব্লক কালো পাত্রে
bird second in line	লাইনে পাখি দ্বিতীয়
english flag printed umbrella	ইংরেজি পতাকা ছাতা ছাতা
stamp on boy's left hand	ছেলের বাম হাতে স্ট্যাম্প
person holding a block of ice	বরফের ব্লক ধরে থাকা ব্যক্তি
large green and purple tennis court	বড় সবুজ এবং বেগুনি টেনিস কোর্ট
A man taking a picture of the players.	খেলোয়াড়দের ছবি তুলছেন এক ব্যক্তি।
Yellow time and date stamp	হলুদ সময় এবং তারিখ স্ট্যাম্প
a fair weather cloud	একটি আবহাওয়া মেঘ
orange date print	কমলা তারিখ মুদ্রণ
tennis players shaking hands	টেনিস খেলোয়াড়রা হাত কাঁপছেন
the block of hay	খড়ের ব্লক
there is a building behind the court	কোর্টের পিছনে একটি বিল্ডিং রয়েছে
proprietor of the mobile lemonade stand	মোবাইল লেবুনেড স্ট্যান্ডের স্বত্বাধিকারী
pole behind second baseman	দ্বিতীয় বেসম্যান পিছনে মেরু
Net separating a tennis	নেট একটি টেনিস পৃথক
A table full of fine china.	একটি সূক্ষ্ম চীন পূর্ণ টেবিল।
The items on the top shelf have painted characters on them	উপরের শেল্ফের আইটেমগুলিতে অক্ষরগুলি আঁকিয়েছে
date palms on the grassy field	ঘাসের মাঠে খেজুর
ground where bike stand	সাইকেল যেখানে দাঁড়িয়ে আছে
the players are wearing cleats on their shoes	প্লেয়াররা তাদের জুতোতে ক্লিট পরে আছে
green shrubbery that forms a circle around the pedestal	পাদদেশের চারপাশে একটি বৃত্ত তৈরি করে এমন সবুজ ঝোপঝাড়
crosswalk for pedestrians to cross	পথচারীদের পারাপারের জন্য ক্রসওয়াক
one side is in english	এক দিক ইংরেজিতে
The water bottle on the stand	স্ট্যান্ডে জলের বোতল
pair of hands typing fast on keyboard	হাত জোড় কীবোর্ডে টাইপ করা
second level of building	বিল্ডিং দ্বিতীয় স্তর
second man looking over first's shoulder	দ্বিতীয় ব্যক্তি প্রথম কাঁধের উপর তাকিয়ে
The birds are flying fast	পাখিরা দ্রুত উড়ছে
time stamp in corner of image	চিত্র কোণে সময় স্ট্যাম্প
light stand beside bed	বিছানার পাশে হালকা স্ট্যান্ড
date 01/05/2011	তারিখ ০১/০৫/২০১১
this court is green	এই কোর্ট সবুজ
a table filled with assorted models and tools	বিভিন্ন মডেল এবং সরঞ্জাম দিয়ে ভরা একটি টেবিল
The cave the wave forms.	গুহাটি তরঙ্গ গঠন করে।
baseball players helmet	বেসবল খেলোয়াড় হেলমেট
Large cross outside of a church.	একটি গির্জার বাইরে বড় ক্রস।
fence on a baseball court	বেসবল কোর্টে বেড়া
large green bench press on the table	টেবিলের উপর বড় সবুজ বেঞ্চ প্রেস
second car attached to train engine	ট্রেন ইঞ্জিনের সাথে সংযুক্ত দ্বিতীয় গাড়ি
a white line cross walk.	একটি সাদা লাইন ক্রস ওয়াক।
expiration date in black ink	কালো কালি শেষ হওয়ার তারিখ
box springs under a bed	একটি বিছানার নীচে বক্স স্প্রিংস
white graffiti on a stand	স্ট্যান্ডে সাদা গ্রাফিটি
block behind the woman	মহিলার পিছনে ব্লক
Glass safety rail on second floor.	দ্বিতীয় তলায় গ্লাস সুরক্ষা রেল।
White marking on the court	কোর্টে সাদা চিহ্ন
bolt on cross walk sign	ক্রস ওয়াক সাইন উপর বল্টু
a white line a cross the field	একটি সাদা লাইন একটি ক্ষেত্র পেরিয়ে
players wearing knee-high socks	খেলোয়াড়রা হাঁটু-উচ্চ মোজা পরা
second man skiing in snow	তুষার দ্বিতীয় স্কিইং
a few people about to cross the road	কিছু লোক রাস্তা পার হতে চলেছে
stop sign in english and farsi	ইংরেজি এবং ফারসি সাইন ইন করুন
a rounded edged wood block	একটি বৃত্তাকার ধারযুক্ত কাঠের ব্লক
Television set on wooden stand	কাঠের স্ট্যান্ডে টেলিভিশন সেট
Four players standing on a tennis court	টেনিস কোর্টে দাঁড়িয়ে চারজন খেলোয়াড়
the tv stand is blacjk incolor	টিভি স্ট্যান্ডটি ব্ল্যাকজক ইনক্লোর
a team of good soccor players.	ভাল সকার খেলোয়াড়দের একটি দল।
the angel is holding a cross shield	দেবদূত একটি ক্রস ঢাল ধরে আছে
a cross on the top of the building	বিল্ডিংয়ের উপরে একটি ক্রস
players watch from the dugout	খেলোয়াড়রা ডাগআউট থেকে দেখুন
stand full of baseball fans	বেসবল ভক্তদের পূর্ণ দাঁড়িয়ে
The cat is looking at the second cat.	বিড়াল দ্বিতীয় বিড়ালের দিকে তাকাচ্ছে।
People with umbrellas waiting to cross the street.	রাস্তা পার হওয়ার অপেক্ষায় ছাতাওয়ালা লোকেরা।
red ground of a tennis court	টেনিস কোর্টের লাল গ্রাউন্ড
the second hand on the clock	ঘড়ির উপর দ্বিতীয় হাত
the small cross on top of the headstone	হেডস্টোন উপরে ছোট ক্রস
White cross walk in road	রাস্তায় সাদা ক্রস ওয়াক
rusty springs beneath 'schwinn'	'স্কুইন' এর নীচে মরিচা ঝর্ণা
truck has two white Chinese characters	ট্রাক দুটি সাদা চীনা অক্ষর আছে
a bunch of baseball players waiting for their turn	বেসবল খেলোয়াড়দের একগুচ্ছ তাদের পালনের জন্য অপেক্ষা করছে
The sign is in arabic and english	সাইন আরবী এবং ইংরেজী ভাষায়
a copy of vanity fair is displayed	ভ্যানিটি মেলার একটি অনুলিপি প্রদর্শিত হয়
the fine is 350 usd	জরিমানা 350 ইউএসডি হয়
a black second hand	একটি কালো দ্বিতীয় হাত
A postage stamp.	একটি ডাকটিকিট
advertisement on tennis court	টেনিস কোর্টে বিজ্ঞাপন
A fruit stand on the sidewalk	ফুটপাতে একটি ফল স্ট্যান্ড
fair large legion of anti-climate change, 350.org, kites with tails in the overcast sky	জলবায়ু পরিবর্তন বিরোধী ন্যায্য বৃহত্তর সৈন্যদল, 350.org, মেঘলা আকাশে লেজযুক্ত ঘুড়ি
the banana hanging from the stand	স্ট্যান্ড থেকে কলা ঝুলছে
a church tower with a cross on the roof	ছাদে ক্রস সহ একটি গির্জার টাওয়ার
Lid of glass cake stand	কাচের কেক স্ট্যান্ডের ঢাকনা 
member of opposing team trying to block the shooter's shot	বিরোধী দলের সদস্য শ্যুটারের শটটি ব্লক করার চেষ্টা করছেন
the stand is stable	স্ট্যান্ড স্থিতিশীল
batter being poured into a waffle press	তরল কাই ওয়াফল প্রেস এ ঢালা হচ্ছে
black metal fence behind a tennis court	টেনিস কোর্টের পিছনে কালো ধাতব বেড়া
cross on the church roof	গির্জার ছাদ উপর ক্রস
clock on the pole	মেরু উপর ঘড়ি
the second young lady is wearing capri-style jeans	দ্বিতীয় যুবতী ক্যাপরি স্টাইলের জিন্স পরেছেন
The blue tennis court	নীল টেনিস কোর্ট
Angels overlooking the cross	দেবদূতরা ক্রসকে অগ্রাহ্য করে
black Samsung tv on the tv stand	কালো স্ট্যান্ড স্যামসং টিভি
Neon green time and date stamp	নিয়ন সবুজ সময় এবং তারিখ স্ট্যাম্প
the blue handle of a french press	একটি ফরাসি প্রেসের নীল হাতল
an alarm clock on the night stand	নাইট স্ট্যান্ডে একটি অ্যালার্ম ঘড়ি
Dark colored stand a tv is on.	গাঢ় রঙিন স্ট্যান্ড একটি টিভি চালু আছে।
second traffic light on pole	স্ট্যান্ডে দ্বিতীয় ট্র্যাফিক আলো 
Old english writing on board	বোর্ডে পুরানো ইংরেজি লেখা
this is a coffee press	এটি একটি কফি প্রেস
Green grass forms the ground.	সবুজ ঘাস মাটি গঠন করে।
sign laying on the second set of red apples	লাল আপেল এর দ্বিতীয় সেট এর উপর সাইন পড়ে আছে 
A sign in not english	ইংরাজিতে নয় এমন একটি সাইন
black remote on the tv stand	টিভি স্ট্যান্ড কালো রিমোট
Windows logo stamp on laptop.	ল্যাপটপে উইন্ডোজ লোগো স্ট্যাম্প।
french press coffee maker on the table	টেবিলে ফ্রেঞ্চ প্রেস কফি প্রস্তুতকারক 
Black stand with microphone	মাইক্রোফোন দিয়ে কালো স্ট্যান্ড
little white english car with vertical oblong taillights	উল্লম্ব বিভাজন টেইলাইট সহ ছোট সাদা ইংলিশ গাড়ি
aqua press wall with white advertising signs	সাদা বিজ্ঞাপনের লক্ষণ সহ একোয়া প্রেস ওয়াল
Soccer players on field.	মাঠে সকার খেলোয়াড়রা।
Top of net on tennis court	টেনিস কোর্টে নেট শীর্ষ
Coming fast around the bend	বাঁক এর পাশে দ্রুতগতিতে আসছে 
Blue border around tennis court	টেনিস কোর্টের চারপাশে নীল সীমানা
ink stamp print	কালি স্ট্যাম্প প্রিন্ট
yellow sticker with asian characters	এশিয়ান অক্ষরের সাথে হলুদ স্টিকার
second seat on motorcycle	মোটরসাইকেলের দ্বিতীয় আসন
four female soccer players on a grassy field	ঘাসের মাঠে চারজন মহিলা ফুটবল খেলোয়াড়
date 2008 printed on the label	তারিখ 2008 লেবেলে মুদ্রিত
grass tennis court	গ্রাস টেনিস কোর্ট
colored springs on truck	ট্রাকে রঙিন স্প্রিং
white cement block wall	সাদা সিমেন্ট ব্লক প্রাচীর
a cats closed eye forms a slit	একটি বিড়াল বদ্ধ চোখ একটি চেরা গঠন
the judge's chair by the court	কোর্ট এর পাশে বিচারক এর চেয়ার
a white surfboard stand next to yellow one	হলুদ রঙের পাশে একটি সাদা সার্ফবোর্ড
a layer of fine sweet chocolate	সূক্ষ্ম মিষ্টি চকোলেট একটি স্তর
the watermark is a block font	ওয়াটারমার্ক একটি ব্লক ফন্ট
red second hand on top of other hands	অন্য কাঁটার উপর লাল সেকেন্ডের কাঁটা
long fine hairs on chin	চিবুকের উপর দীর্ঘ সূক্ষ্ম চুল
Single white line drawn on tennis court	টেনিস কোর্টে টানা একক সাদা লাইন
a red cross decal	একটি রেড ক্রস ডেসাল
Blue garbage can on second floor.	নীল আবর্জনা দ্বিতীয় তলায় করতে পারেন।
front of military plane is pointed and fast	সামরিক বিমানের সামনে পয়েন্ট এবং দ্রুত হয়
signature of artist and date	শিল্পীর স্বাক্ষর এবং তারিখ
book of forms on desk	ডেস্কে ফর্ম বই
Silver french press coffee maker	সিলভার ফরাসি প্রেস কফি প্রস্তুতকারক
orange date stamp on photo	ছবির উপর কমলা তারিখ স্ট্যাম্প
woman in back of a court	কোর্টের পিছনে মহিলা
the date of the picture	ছবির তারিখ
gray color on court	কোর্টে ধূসর রঙ
small models boats on TV	ছোট মডেল টিভিতে নৌকা
glass block privacy wall	কাচ ব্লক গোপনীয়তা প্রাচীর
red painted lines on wooden court floor	কাঠের কোর্ট ফ্লোরে লাল আঁকা লাইন
red cross with a white background	একটি সাদা পটভূমি সঙ্গে রেড ক্রস
soccer players in a light blue uniforms	হালকা নীল রঙের ইউনিফর্মে ফুটবল খেলোয়াড়
car moving incredibly fast	অবিশ্বাস্যভাবে দ্রুত গাড়ী চলমান
a small dark brown night stand	একটি ছোট গাঢ় বাদামী নাইট স্ট্যান্ড
a sign in a language that isn't English	ইংরাজী নয় এমন একটি ভাষায় সাইন
silver and black French press coffee pot	সিলভার এবং কালো ফরাসি প্রেস কফি পাত্র
green bench on court	কোর্টে সবুজ বেঞ্চ
pendent on a fine chain	একটি সূক্ষ্ম চেইন উপর দুল
Paper forms on the table.	টেবিলে কাগজের ফর্মগুলি।
A ball girl at the back of a tennis court	টেনিস কোর্টের পিছনে একটি বালিকা
Thick white wooden cross.	ঘন সাদা কাঠের ক্রস।
the second cushioned seat	দ্বিতীয় কুশনযুক্ত আসন
A black barrier stand.	একটি কালো বাধা স্ট্যান্ড।
green surface surrounding tennis court	টেনিস কোর্টের চারপাশে সবুজ পৃষ্ঠ
Silhouette of tennis player on court.	কোর্টে টেনিস খেলোয়াড়ের সিলুয়েট।
black electric clock on night stand	নাইট স্ট্যান্ডে কালো বৈদ্যুতিন ঘড়ি
a skate boarder going fast	একজন স্কেট বোর্ডার দ্রুত যাচ্ছেন
5 cars of varying models parked on the street	রাস্তায় পার্কিং বিভিন্ন মডেলের 5 টি গাড়ি
Signs on signpost naming streets and block numbers	সাইনপোস্ট নামকরণ রাস্তায় এবং ব্লক নম্বরগুলিতে চিহ্ন
big hairy fair laps	বড় লোমশ ফর্সা কোল
white edge of white tennis court	সাদা টেনিস কোর্ট সাদা প্রান্ত
name and date in the corner	কোণে নাম এবং তারিখ
yellowish green grass over fine tan sand	সূক্ষ্ম ট্যান বালির উপরে হলুদ সবুজ ঘাস
small child cross country skiing	ছোট শিশু ক্রস কান্ট্রি স্কিইং
a net divides the court	একটি নেট কোর্ট বিভক্ত
walking so fast person is captured as a blur	এত তাড়াতাড়ি হাঁটলে একজন মানুষকে ঝাপসা হয়ে যায়
the knife block is filled	ছুরির ব্লকটি ভরে গেছে
Long forks and springs	দীর্ঘ কাঁটাচামচ এবং ঝর্ণা
baseball players dressed in red and gray	বেসবল খেলোয়াড়রা লাল এবং ধূসর পোশাকে
second paper notice in a row	পরপর দ্বিতীয় কাগজ নোটিশ
second story seating area	দ্বিতীয় গল্পের বসার জায়গা
a cross country skier bending low	কম ক্রস কান্ট্রি স্কাইয়ার
Shadow running across a tennis court	টেনিস কোর্ট জুড়ে ছায়া চলছে
Coolers in front of the players.	খেলোয়াড়দের সামনে কুলার।
Cartoon characters on top of the building.	বিল্ডিংয়ের উপরে কার্টুন চরিত্রগুলি।
black lamp with floor stand	মেঝে স্ট্যান্ড সহ কালো বাতি
Security officer making sure everyone is safe at the fair	সুরক্ষার আধিকারিক নিশ্চিত করছেন মেলায় সবাই নিরাপদে আছেন
the springs are silver	ঝর্ণা রূপা হয়
sticker is blue+white and i think written in English+kanji	স্টিকারটি নীল + সাদা এবং আমার মনে হয় ইংরেজিতে + কঞ্জি লেখা আছে
a white sign not in English	একটি সাদা চিহ্ন ইংরাজীতে নয়
man working at stand	লোক স্ট্যান্ড এ কাজ
man standing in a tennis court	টেনিস কোর্টে দাঁড়িয়ে লোক
black band on players wrist	খেলোয়াড়ের কব্জিতে কালো ব্যান্ড
Name and date on the bottom right corner.	নীচে ডান কোণে নাম এবং তারিখ।
red second hand	লাল দ্বিতীয় হাত
orange line on court	কোর্টে কমলা রেখা
date on the screen	পর্দায় তারিখ
Baseball cap to block sun	বেসবল ক্যাপ রোদে ব্লক
a missing cider block opening to the outside	বাইরে থেকে একটি অনুপস্থিত সাইডার ব্লক
a cross on the top of the church	গির্জার উপরে একটি ক্রস
green grass by tennis court	টেনিস কোর্ট দ্বারা সবুজ ঘাস
Some traffic is moving very fast	কিছু ট্র্যাফিক খুব দ্রুত চলছে
Large blue flag above the entire fair	পুরো মেলার উপরে বড় বড় নীল পতাকা
A crack on the court	কোর্টে একটি ফাটল
The tennis players arm extended.	টেনিস খেলোয়াড়দের হাত বাড়ানো।
concrete block near street.	রাস্তার কাছে কংক্রিট ব্লক
Number of court on the wall.	দেয়ালে কোর্টের সংখ্যা।
wooden sign with white letters on second bus	দ্বিতীয় বাসে সাদা বর্ণের সাথে কাঠের চিহ্ন
exte stamp on yellow metal	হলুদ ধাতু উপর স্ট্যাম্প exte
tree root jutting out in jagged forms	ঝাঁকুনিযুক্ত ফর্মগুলিতে গাছের শিকড় কাটছে
microphones are lined up on stand	মাইক্রোফোনগুলি স্ট্যান্ডে রেখাযুক্ত থাকে
the white cross on the flag	পতাকা সাদা ক্রস
the yellow block in the parking stall	পার্কিং স্টলে হলুদ ব্লক
a sign that forms an X	এমন একটি চিহ্ন যা একটি এক্স গঠন করে
Land forms in the distance	দূরত্বে জমি ফর্ম
playing on green and blue court	সবুজ এবং নীল কোর্টে বাজানো
the sport is cross country	খেলাটি ক্রস কান্ট্রি
this wall forms a stall	এই প্রাচীর একটি স্টল গঠন
A metal and stone column holding a bell and cross.	একটি ধাতু এবং পাথর কলাম একটি ঘন্টা এবং ক্রস ধারণ করে।
a tea set on a wooden stand	একটি কাঠের স্ট্যান্ডে একটি চা সেট
this is a press conference	এটি একটি সংবাদ সম্মেলন
second airplane leaves smoke trail	দ্বিতীয় বিমান ধোঁয়া ট্রেল ছেড়ে
white characters on the street	রাস্তায় সাদা অক্ষর
people eating fast food	লোকেরা ফাস্টফুড খাচ্ছে
date in the corner	কোণে তারিখ
Silver cross necklace	সিলভার ক্রস নেকলেস
block of snow on a hill	একটি পাহাড়ে তুষার ব্লক
a red and white county fair tent	একটি লাল এবং সাদা কাউন্টি ফর্সা তাঁবু
long fine whiskers on a cat	একটি বিড়াল উপর দীর্ঘ সূক্ষ্ম ফিসফিসার
man in a white hat on the tennis court	টেনিস কোর্টে একটি সাদা টুপি লোক
a man in a yellow t-shirt sitting cross-legged	হলুদ টি-শার্টের এক লোক ক্রস লেগে বসে আছে
long single block in row	সারিবদ্ধ দীর্ঘ একক ব্লক
Two fine drinking glasses	দুটো সূক্ষ্ম মদ্যপান
green baseball field with players on it	গ্রিন বেসবল মাঠে এটি খেলোয়াড়দের সাথে
Man stand in crane	মানুষ ক্রেনে দাঁড়িয়ে আছে
The characters 9F on the side of a plane	একটি বিমানের পাশে 9F অক্ষর
English city bus on the road	রাস্তায় ইংলিশ সিটি বাস
the date is probably somehow, somewhat primitively digitally conveyed	তারিখটি সম্ভবত একরকম, কিছুটা প্রাথমিকভাবে ডিজিটালভাবে জানানো হয়েছে
blue plastic hot dog stand	নীল প্লাস্টিকের হট ডগ স্ট্যান্ড
A dirty white dish towel with red cross stripes	রেড ক্রস স্ট্রাইপযুক্ত একটি নোংরা সাদা ডিশ তোয়ালে
Two baseball players talking to each other	দুই বেসবল খেলোয়াড় একে অপরের সাথে কথা বলছে
long net across the court	কোর্ট জুড়ে দীর্ঘ নেট
a person cross country skiing in the background	একজন ব্যক্তি পটভূমিতে দেশ স্কিইং ক্রস করে
baseball players on field	মাঠে বেসবল খেলোয়াড়
Yellow and black pole with a yellow cross.	একটি হলুদ ক্রস সহ হলুদ এবং কালো পোল।
A white box with a red cross.	একটি লাল ক্রসযুক্ত একটি সাদা বাক্স।
Bread dough cross hatched design	রুটি ময়দার ক্রস হ্যাচড ডিজাইন
White boundary lines on the tennis court.	টেনিস কোর্টে সাদা সীমানা লাইন।
waves forms behind the boat	তরঙ্গ নৌকা পিছনে ফর্ম
second floor balcony	দ্বিতীয় তল বারান্দা
fast food hot dogs and onion rings	ফাস্ট ফুড হট কুকুর এবং পেঁয়াজ রিং
Time date stamp is bottom right	সময় তারিখ স্ট্যাম্প নীচে ডান
12/22/2006 date stamp	12/22/2006 তারিখ স্ট্যাম্প
fine grey gravel under players' legs	খেলোয়াড়দের পায়ের নীচে জরিমানা ধূসর কঙ্কর
lamp stand light	বাতি স্ট্যান্ড আলো
a professional tennis court	একটি পেশাদার টেনিস কোর্ট
Tall date palm	লম্বা খেজুর
Dresser with dinosaur models on top	শীর্ষে ডাইনোসর মডেল সহ ড্র্রেসার
top of tennis court	টেনিস কোর্ট শীর্ষ
Woman dressed as a maiden at the fair	মেলায় প্রথম মেয়েটির পোশাক পরা মহিলা
characters apart on stage set	মঞ্চে সেট অক্ষর পৃথক
Chinese characters on the back of the truck	ট্রাকের পেছনে চীনা অক্ষর
fast blue and white train	দ্রুত নীল এবং সাদা ট্রেন
players name on his shirt	তার শার্টে খেলোয়াড়দের নাম
College baseball players on the field.	মাঠে কলেজ বেসবল খেলোয়াড়।
blue court on the ground	মাটিতে নীল কোর্ট
Two toasted English muffins on a plate.	একটি প্লেটে দুটি টোস্টেড ইংলিশ মাফিনস।
Bag on the cement block	সিমেন্ট ব্লকে ব্যাগ
flower on ice block	আইস ব্লকে ফুল
yellow tennis balls on court	কোর্টে হলুদ টেনিস বল
A person waiting to cross the street	রাস্তা পার হওয়ার অপেক্ষায় থাকা এক ব্যক্তি
tan colored brick block wall	ট্যান রঙিন ইট ব্লক প্রাচীর
A dark wooden cross with a small sign attached	একটি গাঢ় কাঠের ক্রস যার সাথে একটি ছোট চিহ্ন যুক্ত রয়েছে
A clock with cartoon characters on	কার্টুন চরিত্রগুলি সহ একটি ঘড়ি
rocky and rectangular block with openings on dirt	ময়লা উপর খোলার সঙ্গে পাথুরে এবং আয়তক্ষেত্রাকার ব্লক
adult on a tennis court	টেনিস কোর্টে প্রাপ্তবয়স্ক
Knives in a wooden block on the countertop.	কাউন্টারটপের একটি কাঠের ব্লকে ছুরিগুলি।
leg of the second person	দ্বিতীয় ব্যক্তির পা
awning for food stand	খাদ্য স্ট্যান্ড জন্য সজাগ
Knives in a wooden block behind the stove.	চুলার পিছনে কাঠের ব্লকে ছুরি।
a red newspaper stand	একটি লাল সংবাদপত্র স্ট্যান্ড
Brown block and white house with pitched black roof.	কালো ছাদযুক্ত ব্রাউন ব্লক এবং সাদা ঘর।
The train is traveling in fair weather	ট্রেনটি ন্যায্য আবহাওয়ায় ভ্রমণ করছে
fast food on white plate	সাদা প্লেটে ফাস্টফুড
air forces flag	বিমান বাহিনী পতাকা
some watery plant forms	কিছু জলযুক্ত উদ্ভিদ ফর্ম
curves of forms worn over shoes on snowboard	স্নোবোর্ডে জুতো পরে ফর্মের বক্ররেখা
woman sitting on a stone block	পাথরের ব্লকে বসে মহিলা 
black lamb second from right	ডান থেকে দ্বিতীয় মেষশাবক
blue wall of the court	কোর্টের নীল প্রাচীর
a wood night stand.	একটি কাঠ নাইট স্ট্যান্ড
the wall is cement block	প্রাচীর সিমেন্ট ব্লক
the court is dark blue	কোর্ট গাঢ় নীল
The man's black shadow on the court	কোর্টে লোকটির কালো ছায়া
Woman standing on tennis court	টেনিস কোর্টে দাঁড়িয়ে মহিলা
a music stand on a curb	একটি সংকোচনের উপর একটি সঙ্গীত স্ট্যান্ড
a weed growing up from the tennis court	টেনিস কোর্ট থেকে আগাছা বাড়ছে
The military plane has a cross on the tail.	সামরিক বিমানের লেজটিতে একটি ক্রস রয়েছে।
small food press on stove	চুলায় ছোট খাবার প্রেস
two bicyclists waiting to cross intersection	চৌরাস্তা পার হওয়ার অপেক্ষায় দুজন সাইকেল চালক
cross nailed to a wall	ক্রস একটি প্রাচীরে গাঁথা
Wooden butcher block on kitchen sink.	রান্নাঘরের বেসিন এর উপর কাঠের বুচার ব্লক
three black Japanese characters	তিনটি কালো জাপানি অক্ষর
microphone on angled stand	কোণযুক্ত স্ট্যান্ডে মাইক্রোফোন
Look of concentration on game players face	গেম খেলোয়াড়দের মুখের প্রতি একাগ্রতার চেহারা
blue cross on front of car	গাড়ির সামনে নীল ক্রস
the blue painted do not cross line on the train platform	নীল রঙে আঁকা ট্রেনের প্ল্যাটফর্মে লাইনটি অতিক্রম করে না
tennis match in progress on outdoor court	আউটডোর কোর্টে টেনিস ম্যাচ চলছে
Two men on a tennis court playing tennis	টেনিস খেলতে টেনিস কোর্টে দুজন লোক
wood block of knives	ছুরির কাঠের ব্লক
A block of brown stones.	বাদামী পাথর একটি ব্লক।
players' names in black on yellow background	হলুদ পটভূমিতে কালো রঙের প্লেয়ারদের নাম
an off white set of box springs	বক্স স্প্রিংস একটি সাদা সাদা সেট
Blue characters on a white background	একটি সাদা পটভূমিতে নীল অক্ষর
TV on the stand.	স্ট্যান্ডে টিভি।
Yellow ball on the court.	কোর্টে হলুদ বল।
Electrical wire stand	বৈদ্যুতিক তারের স্ট্যান্ড
cross made of stone	পাথরের তৈরি ক্রস
The traffic light has a red cross.	ট্র্যাফিক লাইটের একটি রেড ক্রস রয়েছে।
ball on a tennis court	টেনিস কোর্টে বল
cross walk area painted on the street	রাস্তায় আঁকা ক্রস ওয়াক এরিয়া
Brown stand holding bananas.	কলা বাদামী স্ট্যান্ড।
the line that shows foul or fair	লাইনটি অশ্লীল বা ফর্সা দেখায়
Knob above knife block	ছুরি ব্লক উপরে গিঁট
A time stamp on a video.	একটি ভিডিওতে টাইম স্ট্যাম্প।
a clock on a glass stand	কাচের স্ট্যান্ডের একটি ঘড়ি
One person on the court	কোর্টে একজন ব্যক্তি
Road block submerged by water	জলে নিমজ্জিত রোড ব্লক
tennis court floor is blue	টেনিস কোর্ট ফ্লোর নীল
baseball players signing autographs	বেসবল খেলোয়াড় অটোগ্রাফ স্বাক্ষর
fine metal safety netting	সূক্ষ্ম ধাতু সুরক্ষা জাল
An audience witnessing a press conference	এক সংবাদ সম্মেলনের সাক্ষী শ্রোতা
players in team dugout	টীম ডাগআউট এ খেলোয়াড়রা
white frisbee in players hands	খেলোয়াড়দের হাতে সাদা ফ্রিসবি
time and date stamp	সময় এবং তারিখ স্ট্যাম্প
A TV stand	একটি টিভি স্ট্যান্ড
The time stamp display window on the meter on the left.	বামদিকে মিটারে সময় স্ট্যাম্প প্রদর্শন উইন্ডো।
a wooden block of knives	ছুরি একটি কাঠের ব্লক
a second story railing	একটি দ্বিতীয় গল্প রেলিং
This is a picture of Chinese characters	এটি চাইনিজ চরিত্রগুলির একটি ছবি
fast super jet hovers in the sky	দ্রুত সুপার জেট আকাশে ঘোরাফেরা করে
the players are moving	খেলোয়াড়রা চলাফেরা করছে
two guys in the background are observing the movements of the players	পটভূমির দু'জন খেলোয়াড় খেলোয়াড়দের চলন পর্যবেক্ষণ করছে 
Curled metal legs on a candle stand	একটি মোমবাতি স্ট্যান্ডের উপর কার্ল ধাতব পা
two players watching the batter	দুই খেলোয়াড় ব্যাটার দেখছেন
fine white spray against nose of craft	নৈপুণ্যের নাকের বিরুদ্ধে সূক্ষ্ম সাদা স্প্রে
Brown tennis court floor	ব্রাউন টেনিস কোর্ট ফ্লোর
cross on top of church	গির্জার উপরে ক্রস
copyright and date	কপিরাইট এবং তারিখ
A sign for the 550 west block of Bliss Ct.	ব্লিস সিটি-এর 550 পশ্চিম ব্লকের জন্য একটি চিহ্ন।
Opponent Reaching Out to block	প্রতিপক্ষ ব্লক করতে পৌঁছেছে
Laptop on a stand	একটি স্ট্যান্ডে ল্যাপটপ
a wooden block sitting on the table	টেবিলের উপর বসে একটি কাঠের ব্লক
Part of the tennis court is green.	টেনিস কোর্টের কিছু অংশ সবুজ।
two players in orange and white sitting on sidelines	কমলা এবং সাদা দুই খেলোয়াড় সাইড লাইনে বসে on
date stamp of photo	ছবির তারিখ স্ট্যাম্প
a pole of a lamp stand	একটি বাতি স্ট্যান্ডের একটি খুঁটি
the door of second floor is brown	দ্বিতীয় তলার দরজাটি বাদামী
Front wheel on second white truck.	দ্বিতীয় সাদা ট্রাকে সম্মুখ চাকা।
the second gold horse	দ্বিতীয় সোনার ঘোড়া
A small grey block on the median	মিডিয়ানের উপর একটি ছোট ধূসর ব্লক
Woman on a tennis court	টেনিস কোর্টে মহিলা
red characters on top of blue building	নীল ভবনের উপরে লাল অক্ষর
the collar decoration of a fair isle type sweater	ফেয়ার আইল টাইপের সোয়েটারের কলার সজ্জা
Woman wearing a cross on her neck	গলায় ক্রস পরা মহিলা
a colorful display lighted characters	একটি বর্ণময় প্রদর্শন আলোকিত অক্ষর
The second train car	দ্বিতীয় ট্রেনের গাড়ি
the players arm is ready to throw	খেলোয়াড়দের হাত ছুঁড়ে ফেলার জন্য প্রস্তুত
date and time stamp in corner	কোণে তারিখ এবং সময় স্ট্যাম্প
Two characters on the television	টেলিভিশনে দুটি চরিত্র
blue net around tennis court	টেনিস কোর্ট কাছাকাছি নীল নেট
a block paved sidewalk	একটি ব্লক প্রশস্ত ফুটপাথ
a orange bottle in stand	স্ট্যান্ডে কমলা বোতল
The items of the second rack	দ্বিতীয় রাকের আইটেম
tan grey fine sand	ট্যান ধূসর সূক্ষ্ম বালি
fence in back of the court	কোর্টের পিছনে বেড়া
five glass vases on the stand	স্ট্যান্ডে পাঁচটি কাচের ফুলদানি
white Asian language characters painted on middle of street	রাস্তার মাঝখানে আঁকা সাদা এশিয়ান ভাষার অক্ষর
second leaf from left	বাম থেকে দ্বিতীয় পাতা
white fast logo in corner	কোণে সাদা দ্রুত লোগো
a large concrete block	একটি বড় কংক্রিট ব্লক
a player on second base	দ্বিতীয় বেস একটি প্লেয়ার
fondant characters on cake	কেক উপর অনুরাগী চরিত্র
grey characters on a sign	একটি চিহ্ন উপর ধূসর অক্ষর
Red tie with Peanuts characters	চিনাবাদামের অক্ষরগুলির সাথে লাল টাই
press here sticker on paw	পাঞ্জা এখানে স্টিকার প্রেস
a sign in a zoo, written in catalan - spanish – english	চিড়িয়াখানায় একটি চিহ্ন, নিখুঁত - স্প্যানিশ - ইংরেজি লেখা
White letters and numbers, indicating date and photographer.	শ্বেত অক্ষর এবং সংখ্যা, ইঙ্গিত করে তারিখ এবং ফটোগ্রাফার।
window on second level	দ্বিতীয় স্তরের উইন্ডো
yellow date and time stamp	হলুদ তারিখ এবং সময় স্ট্যাম্প
players playing base ball on field	খেলোয়াড়রা মাঠে বেস বল খেলছেন
a black fine tooth comb	একটি কালো সূক্ষ্ম দাঁত চিরুনি
a second daybed in room	রুমে একটি দ্বিতীয় দিন
lots of kick+grab marks on white wall below blurry words of graffiti [likely not in english]	গ্রাফিতির অস্পষ্ট শব্দের নীচে সাদা দেয়ালে প্রচুর কিক + দখল চিহ্ন [সম্ভবত ইংরেজিতে নয়]
people enjoying themselves at the fair	মানুষ মেলায় নিজেকে উপভোগ করছে
bananas and oranges on fruit stand	কলা এবং কমলা ফলের স্ট্যান্ডে
A small food stand on wheels.	চাকা উপর একটি ছোট খাবার স্ট্যান্ড।
fine china plate with gold rim	সোনার রিম দিয়ে সূক্ষ্ম চীনার প্লেট
a white alarm clock is on top of the night stand	নাইট স্ট্যান্ডের উপরে একটি সাদা অ্যালার্ম ঘড়ি রয়েছে
baseball players sitting in dugout	বেসবল খেলোয়াড় dugout বসে
letter on the wood block	কাঠের ব্লকে চিঠি
Two butcher block knive sets.	দুটি কসাই ব্লক নাইভ সেট।
A sideways rendered date stamp	পার্শ্ববর্তী স্থানে তারিখের স্ট্যাম্প রেন্ডার করা
White second story porch	সাদা দ্বিতীয় গল্প বারান্দা
a door on the side of the court	দরজার পাশের একটি দরজা
a block defining the space for the bench	বেঞ্চের জন্য স্থান নির্ধারণকারী একটি ব্লক
block of white text	সাদা পাঠ্য ব্লক
a brown cat is stand	একটি বাদামী বিড়াল স্ট্যান্ড হয়
A train is going very fast	একটি ট্রেন খুব দ্রুত চলছে
Red and white Stop sign with characters in a non-English language	অ-ইংরাজী ভাষায় অক্ষরগুলির সাথে লাল এবং সাদা স্টপ সাইন
the shin guard on the players leg	খেলোয়াড়দের পায়ে শিন গার্ড
A tennis player standing in the court	একটি টেনিস খেলোয়াড় কোর্টে দাঁড়িয়ে
women waiting to cross	ক্রস করার অপেক্ষায় মহিলারা
blue tennis court with painted white boundary lines	আঁকা সাদা সীমানা লাইন দিয়ে নীল টেনিস কোর্ট
white asphalt with fine lines	সূক্ষ্ম লাইনের সাথে সাদা ডামাল
date the photo was taken	তারিখটি ছবি তোলা হয়েছিল
block of cheese on plate	প্লেটে পনির ব্লক
They both are playing on a tennis court.	তারা দুজনেই টেনিস কোর্টে খেলছেন।
leaves on tennis court	টেনিস কোর্ট ছেড়ে
a cross street sign	একটি ক্রস রাস্তার চিহ্ন
the net across their court	তাদের কোর্ট জুড়ে নেট
geyer springs street sign	জিয়ার স্প্রিংস রাস্তার চিহ্ন
couple guys walking on tennis court	টেনিস কোর্টে হাঁটা দম্পতি
wooden cross hanging on a wall	একটি দেয়ালে ঝুলন্ত কাঠের ক্রস
cross structures for bridge support	ব্রিজ সমর্থন জন্য ক্রস কাঠামো
boy standing on tennis court	টেনিস কোর্টে দাঁড়িয়ে ছেলে
Banana shaped yellow banana stand	কলা আকারের হলুদ কলা স্ট্যান্ড
A person below the date	তারিখের নীচে একজন ব্যক্তি
green tennis court with white lines	সাদা লাইন সঙ্গে সবুজ টেনিস কোর্ট
man stand on skateboard	মানুষ স্কেটবোর্ডে দাঁড়িয়ে আছে
The front wheel of the second bus.	দ্বিতীয় বাসের সামনের চাকা।
Bizarre sculpture on a coffee stand	একটি কফি স্ট্যান্ডে উদ্ভট ভাস্কর্য
large cement block	বড় সিমেন্ট ব্লক
this stand is yellow in color	এই স্ট্যান্ডটি হলুদ বর্ণের
date stamp of scene	দৃশ্যের তারিখ স্ট্যাম্প
Propellers too fast to see.	প্রোপেলাররা দেখতে খুব দ্রুত।
a block, yellow, and white baseball uniform	একটি ব্লক, হলুদ এবং সাদা বেসবল ইউনিফর্ম
players shoes are black, red, and white	খেলোয়াড়ের জুতা কালো, লাল এবং সাদা
The players are giving a high five	খেলোয়াড়রা উচ্চ পাঁচজন দিচ্ছেন
person has a stamp on her hand	ব্যক্তির হাতে একটি স্ট্যাম্প আছে
Copy right date 2010	সঠিক তারিখ 2010 অনুলিপি করুন
low grey wall behind players	খেলোয়াড়দের পিছনে কম ধূসর প্রাচীর
a green part of a tennis court.	টেনিস কোর্টের সবুজ অংশ।
the second street light	দ্বিতীয় স্ট্রিট লাইট
Two tennis players standing together	দুই টেনিস খেলোয়াড় একসাথে দাঁড়িয়ে
two tennis players wearing black shorts	কালো শর্টস পরা দুই টেনিস খেলোয়াড়
the players socks are blue	প্লেয়ার মোজা নীল হয়
A red date stamp	একটি লাল তারিখ স্ট্যাম্প
Monitor stand below monitor	মনিটরের মনিটরের নীচে স্ট্যান্ড করুন
a manual press machine	একটি ম্যানুয়াল প্রেস মেশিন
long black pipe on display stand	ডিসপ্লে স্ট্যান্ডে দীর্ঘ কালো পাইপ
male cross country skier	পুরুষ ক্রস কান্ট্রি স্কিয়ার
models of airplanes on the tables	টেবিলগুলিতে বিমানের মডেল
Man cross country skiing.	ম্যান ক্রস কান্ট্রি স্কিইং।
the sign has white characters	চিহ্নটিতে সাদা বর্ণ রয়েছে
red time stamp on the photo	ছবির উপর লাল সময় স্ট্যাম্প
little girl standing on a tennis court	টেনিস কোর্টে দাঁড়িয়ে ছোট মেয়ে
man cross country skiing during race	ম্যান ক্রস কান্ট্রি স্কিইং রেসের সময়
Cement forms sticking out of ground.	সিমেন্ট ফর্ম স্থল থেকে দূরে থাকে।
Sandwich on the second shelf.	দ্বিতীয় বালুচরে স্যান্ডউইচ।
the english muffins are toasted	ইংলিশ মাফলিন টোস্ট করা হয়
yellow front of second train	দ্বিতীয় ট্রেনের হলুদ সামনে
models posing on motorcycle	মডেল মোটরসাইকেলের উপর অঙ্গবিন্যাস
This open-air stand takes place in Jamaica	এই ওপেন-এয়ার স্ট্যান্ডটি জামাইকাতে স্থান নেয়
clear stand for controller	নিয়ামক জন্য স্পষ্ট অবস্থান
black armed forces name on wing	কালো সশস্ত্র বাহিনীর নাম উইংয়ে
second base found directly behind the pitcher	কলসিটির পিছনে সরাসরি দ্বিতীয় বেস পাওয়া যায়
A cross on a tower.	একটি টাওয়ারের উপরে একটি ক্রস।
picture taken at drive up fast food chain	ড্রাইভ আপ ফাস্ট ফুড চেইন ছবি
two horses stand on hill	দুটি ঘোড়া পাহাড়ে দাঁড়িয়ে আছে
cross centered in curved panels	বক্র প্যানেল কেন্দ্রিক ক্রস
white stripes in road is a pedestrian cross walk	রাস্তায় সাদা স্ট্রাইপগুলি একটি পথচারী ক্রস হাঁটা
Box springs of bed.	বিছানা বক্স স্প্রিংস।
The water bottle on the side of the court.	কোর্টের পাশে জলের বোতল 
A small wave forms on the water.	জলের উপর একটি ছোট তরঙ্গ গঠন করে।
a daytime picture of a couple cross country skiing	একটি দম্পতি ক্রস কান্ট্রি স্কিইংয়ের একটি দিনের চিত্র
Cars moving at a very fast speed	গাড়িগুলি খুব দ্রুত গতিতে চলেছে
a tree on a city block	একটি শহরের ব্লকের একটি গাছ
a cement block wall	একটি সিমেন্ট ব্লক প্রাচীর
computer monitor on the stand	স্ট্যান্ডে কম্পিউটার মনিটর
snow on the trees at a cross-country ski race	ক্রস-কান্ট্রি স্কি রেসে গাছগুলিতে তুষার
the second engine of the train	ট্রেনের দ্বিতীয় ইঞ্জিন
a black music stand	একটি কালো সঙ্গীত স্ট্যান্ড
chairs and tables on the side of the court	কোর্টের পাশে চেয়ার এবং টেবিল
Baseball travelling fast in the air	বেসবল দ্রুত বাতাসে ভ্রমণ করে
fast food soda cups	ফাস্ট ফুড সোডা কাপ
An old wooden stand shade	একটি পুরানো কাঠের স্ট্যান্ড শেড
red on players sleeve	খেলোয়াড়দের হাতা উপর লাল
a stand next to the sink	বেসিন এর পাশে একটি স্ট্যান্ড
second hand on clock	ঘড়ির উপর সেকেন্ডের কাঁটা
four men on court	কোর্টে চার জন
a block wall behind the man	লোকটির পিছনে একটি ব্লক প্রাচীর
cross walk at intersection	চৌরাস্তা ক্রস ওয়াক
large tennis court	বড় টেনিস কোর্ট
Child sitting cross-legged on the floor	বাচ্ছাটি মেঝেতে পা ভাঁজ করে বসে আছে 
Man standing on a tennis court	টেনিস কোর্টে দাঁড়িয়ে মানুষ
yellow time date stamp	হলুদ সময় তারিখ স্ট্যাম্প
Turnstyle entrance to court	কোর্টে টার্নস্টাইল প্রবেশ
horse running fast with cowboy on the back	পেছনে কাউবয় সঙ্গে দ্রুত ঘোড়া
blue umbrella pole held fast by sand	নীল ছাতা মেরুটি বালি দ্বারা ধরে রাখা
blue wood life guard stand	নীল কাঠের লাইফ গার্ড স্ট্যান্ড
gloves are in the players back pocket	গ্লাভস প্লেয়ারদের পিছনে পকেটে রয়েছে
seats in the stand	স্ট্যান্ডে আসন
the players glove is black	খেলোয়াড়দের গ্লোভ কালো
a brown horse with an english saddle	একটি ইংরেজী জিনযুক্ত একটি বাদামী ঘোড়া
The canvas sits on the stand	ক্যানভাস স্ট্যান্ডে বসে
a camera on a stand	একটি স্ট্যান্ডে একটি ক্যামেরা
net of the tennis court	টেনিস কোর্ট নেট
man sitting in fruit stand	মানুষ ফলের স্ট্যান্ডে বসে
grill press	গ্রিল প্রেস
cross on tower steeple	টাওয়ার স্টেপল উপর ক্রস
ink stamp in the pencil box	পেন্সিল বাক্সে কালি স্ট্যাম্প
small table lamp on the night stand	নাইট স্ট্যান্ডে ছোট টেবিল ল্যাম্প
series of curved forms around body	শরীরের চারপাশে বাঁকা ফর্ম সিরিজ
a clock on a wooden block	কাঠের ব্লকের একটি ঘড়ি 
edge of a stamp	একটি স্ট্যাম্প প্রান্ত
a man sitting cross legged in the grass	একটি লোক ঘাসে পা ভাঁজ করে বসেছে
Right ear of the second cat	দ্বিতীয় বিড়ালের ডান কান
a fine bristled retractable brush	একটি সূক্ষ্ম ব্রিসলেড প্রত্যাহারযোগ্য ব্রাশ
A motorcyclist driving very fast	একজন মোটরসাইকেল চালক খুব দ্রুত গাড়ি চালাচ্ছেন
a baseball players bat	একটি বেসবল খেলোয়াড় ব্যাট
A second sandwich on a wrapper.	একটি মোড়কের উপর একটি দ্বিতীয় স্যান্ডউইচ।
case with cross on it also has red trim	এটি ক্রস সঙ্গে কেস এছাড়াও লাল ছাঁটাই আছে
a railing on a second story balcony	দ্বিতীয় তলের বারান্দায় একটি রেলিং
Two soccer players	দুই ফুটবল খেলোয়াড়
the cross on the top of the building structure	বিল্ডিং কাঠামো শীর্ষে ক্রস
People waiting to cross street	রাস্তা পার হওয়ার অপেক্ষায় থাকা মানুষ
characters on the sign	সাইন অক্ষর
A skateboard with asian characters painted on the underside	আন্ডারসাইডে আঁকা এশিয়ান অক্ষর সহ একটি স্কেটবোর্ড
fine inscriptions on item	আইটেম উপর সূক্ষ্ম শিলালিপি
characters are posted in Chinese	অক্ষরগুলি চীনা ভাষায় পোস্ট করা হয়
Man getting ready for a penalty kick	পেনাল্টি কিকের জন্য প্রস্তুত মানুষ
A red cross forms on the floor.	মেঝেতে একটি লাল ক্রস গঠন।
many wires criss-cross overhead	অনেক তারের ক্রাইস-ক্রস ওভারহেড
This could be at a science fair.	এটি একটি বিজ্ঞান মেলায় হতে পারে।
man using a hand press to make juice	মানুষ রস তৈরি করতে একটি হাত প্রেস ব্যবহার করে
The picture has a date stamp	ছবিটিতে একটি তারিখের স্ট্যাম্প রয়েছে
A date underneath a clock face	একটি ঘড়ির মুখের নীচে একটি তারিখ
unfinished wood block under freezer	ফ্রিজারের অধীনে অসম্পূর্ণ কাঠের ব্লক
fast train moving along track	দ্রুত ট্রেন ট্র্যাক বরাবর চলমান
Three baseball players wearing white uniforms are in the background.	সাদা ইউনিফর্ম পরা তিনটি বেসবল খেলোয়াড় পটভূমিতে রয়েছে।
tennis player on the green colored section of a court	একটি কোর্টের সবুজ বর্ণের বিভাগে টেনিস খেলোয়াড়
making a very fast turn	খুব দ্রুত পালা করা
the tennis court net divides the court in the middle	টেনিস কোর্ট নেট মাঝখানে কোর্ট বিভক্ত
4 players on the court	কোর্টে ৪ জন খেলোয়াড়
the chinese characters on the vase	দানি উপর চীনা অক্ষর
crumbly english muffin bread	ঝুরঝুরে ইংলিশ মাফিন রুটি
a stand with information	তথ্য সহ একটি স্ট্যান্ড
ad on the wall of the court	কোর্টের দেয়ালে বিজ্ঞাপন
The right front window on the second level of the bus.	বাসের দ্বিতীয় স্তরের ডান সামনের জানালা
the Asian characters are red	এশীয় চরিত্রগুলি লাল
block tower on top of hill	পাহাড়ের উপরে ব্লক টাওয়ার
The black baseball mit on the players hand	খেলোয়াড়দের হাতে কালো বেসবল মিট
yellow cross on a tie	একটি টাই উপর হলুদ ক্রস
five baseball players	পাঁচ বেসবল খেলোয়াড়
large date palm in the distance	দূরত্বে বড় খেজুর
Cows laying down in the hay at a county fair	কাউন্টি মেলায় খড়ের গায়ে শুয়ে গাভী
armed forces identifying patch for US Army	সশস্ত্র বাহিনী মার্কিন সেনাবাহিনীর জন্য প্যাচ চিহ্নিত করে
The tennis court is two different colors.	টেনিস কোর্ট দুটি ভিন্ন রঙ।
A indoor tennis court.	একটি ইনডোর টেনিস কোর্ট।
characters on the edge of the plate	প্লেটের প্রান্তে অক্ষর
a fruit stand with lots of fruits and vegetables	প্রচুর ফল এবং সবজি সহ একটি ফল স্ট্যান্ড 
red white and blue truck is at the fair	লাল সাদা এবং নীল ট্রাক মেলায়
yellow date taken stamp	হলুদ তারিখ নেওয়া স্ট্যাম্প
Tarp on the side of the court	কোর্টের পাশে টার্প
Tall lights at the court	দরবারে লম্বা লাইট
players standing behind chain link fence	চেইন লিঙ্ক বেড়া পিছনে দাঁড়িয়ে খেলোয়াড়রা
date stamp in the corner	কোণে তারিখ স্ট্যাম্প
a cross in a church	একটি গির্জার ক্রস
easel stand for painting	পেইন্টিং জন্য ইজিল স্ট্যান্ড
owners manual for a panini press	একটি পানিনি প্রেসের জন্য মালিকদের ম্যানুয়াল
dog forms splashes in the water	কুকুর জল ছেটাচ্ছে
two long and narrow panes below cross bar	ক্রস বারের নীচে দুটি দীর্ঘ এবং সরু ফলক
Double red doors on second floor	দ্বিতীয় তলায় ডাবল লাল দরজা
Partial view of second bus	দ্বিতীয় বাসের আংশিক দৃশ্য
White door on second floor	দ্বিতীয় তলায় সাদা দরজা
a romantic date night	একটি রোমান্টিক তারিখ রাত
knife block sitting on counter with knives in it	এটিতে ছুরি নিয়ে কাউন্টারে বসে চাকু ব্লক
a block of buildings	বিল্ডিং একটি ব্লক
Curved stairs on the approach to the court yard	কোর্ট ইয়ার্ডে যাওয়ার জন্য বাঁকানো সিঁড়ি
chinese characters on the side of a bus	একটি বাসের পাশে চীনা অক্ষর
blue tennis court	নীল টেনিস কোর্ট
This person is waiting to cross the street	এই ব্যক্তি রাস্তায় পারাপারের জন্য অপেক্ষা করছেন
The block for the post	পোস্টের জন্য ব্লক
tan letters on the tennis court	টেনিস কোর্টে ট্যান চিঠি
this license plate has non-english characters	এই লাইসেন্স প্লেটে অ-ইংরেজি অক্ষর রয়েছে
players uniform is black and gold	খেলোয়াড়দের ইউনিফর্মটি কালো এবং সোনার
Watermark, showing copyright date.	ওয়াটারমার্ক, কপিরাইটের তারিখ দেখাচ্ছে।
name and website of photographer and Chinese characters	নাম এবং ফটোগ্রাফার এবং চীনা অক্ষর ওয়েবসাইট
tv on a stand	স্ট্যান্ডে টিভি
grass grows next to the block	ব্লকের পাশে ঘাস জন্মে
A paper towel roll on a stand	একটি স্ট্যান্ডে একটি কাগজের তোয়ালে রোল
white springs under mattress	গদিতে সাদা ঝর্ণা
The brick wall behind the court	কোর্টের পিছনে ইটের দেয়াল
egg shaped object on a stand	স্ট্যান্ডে ডিমের আকারের বস্তু
tennis ball shadow on the court	কোর্টে টেনিস বল ছায়া
littleyiye photographers stamp	ছোট্টই ফটোগ্রাফারদের স্ট্যাম্প
Picture stamped date 8/10/2013.	ছবি স্ট্যাম্পড তারিখ 8/10/2013।
2010 date in black	২০১০ তারিখে কালো
sign above the people at the fair	মেলায় লোকদের উপরে সাইন ইন করুন
Straight fine black hair	সোজা সূক্ষ্ম কালো চুল
a horse with an english saddle	একটি ইংরেজী জিনযুক্ত একটি ঘোড়া
the baby has very fine hair	শিশুর খুব সুন্দর চুল রয়েছে has
pelican forms ripples with legs	পেলিকান পায়ে দিয়ে রিপ্লেস গঠন করে
A window on a second story shop.	দ্বিতীয় গল্পের দোকানে একটি উইন্ডো।
Green stand in the snow.	বরফে সবুজ স্ট্যান্ড।
display models of cell phones	সেল ফোন মডেল প্রদর্শন
black chinese characters n white sign	কালো চীনা অক্ষর এন হোয়াইট সাইন
Shadow of the man on the tennis court	টেনিস কোর্টে লোকটির ছায়া
white marking on tennis court	টেনিস কোর্টে সাদা চিহ্ন
Baby fine light brown hair.	বাবু সূক্ষ্ম হালকা বাদামী চুল।
the players lean on the fence	খেলোয়াড়দের বেড়া উপর ঝুঁকুন
second suitcase on bottom is orange	নীচে দ্বিতীয় স্যুটকেস কমলা হয়
Man helping child stand on snowboard	শিশু স্নোবোর্ডে দাঁড়াতে সহায়তা করে লোক
extremely fast bullet train	অত্যন্ত দ্রুত বুলেট ট্রেন
Oriole on front of players hat	ওরিওল খেলোয়াড়দের সামনে টুপি
Net across the tennis court	টেনিস কোর্ট জুড়ে নেট
second car parked on the street	দ্বিতীয় গাড়ী রাস্তায় পার্ক
Cather's mit for hand protection against fast pitches.	দ্রুত পিচের বিরুদ্ধে হাত রক্ষার জন্য ক্যাথার মিট।
fast food chicken patty	ফাস্ট ফুড মুরগির প্যাটি
sunglasses of second rider	দ্বিতীয় রাইডারের সানগ্লাস
People buying food on fast food store	লোকেরা ফাস্টফুড স্টোরে খাবার কিনে থাকে
second animal in the back	পিছনে দ্বিতীয় প্রাণী
the stand under the tv	টিভির নীচে স্ট্যান্ড
tennis court with white stripes	সাদা ফিতে সঙ্গে টেনিস কোর্ট
kick stand on motorcycle	মোটরসাইকেলের উপর কিক স্ট্যান্ড
chainlink fencing forms a field exit	চেইনলিংক বেড়া একটি ক্ষেত্র প্রস্থান করে
Wall design of people characters.	মানুষের চরিত্রগুলির ওয়াল ডিজাইন।
the sidewalk in front of the produce stand	উত্পাদনের স্ট্যান্ডের সামনের ফুটপাত
concrete or cinder block walls	কংক্রিট বা সিন্ডার ব্লক দেয়াল
The tv stand is made of wood	টিভি স্ট্যান্ডটি কাঠের তৈরি
the models perky lips	মডেল বেহায়া ঠোঁট
Three baseball players at first base	প্রথম বেসে তিনটি বেসবল খেলোয়াড়
block of black butcher knives	কালো কসাই ছুরি ব্লক
pointing sign in english and chinese	ইংরাজী এবং চীনা মধ্যে সাইন ইন
Lamp on the night stand to the left of the bed	বিছানার বাম দিকে নাইট স্ট্যান্ডে প্রদীপ
Date stamp of March 16th, 2008	16 শে মার্চ, 2008 তারিখের ডাকটিকিট
coca cola international logo, written in english, probably repeated below	কোকা কোলা আন্তর্জাতিক লোগো, ইংরেজিতে লেখা, সম্ভবত নীচে পুনরাবৃত্তি হয়েছে
a white sign with black Asian characters going vertically	কালো এশিয়ান অক্ষরগুলির সাথে একটি সাদা চিহ্ন 
bicycle stamp on road	রাস্তায় সাইকেল স্ট্যাম্প
neon sign in a second floor window	দ্বিতীয় তল উইন্ডোতে নিয়ন সাইন
this couple is on a date	এই দম্পতি একটি তারিখে হয়
Mcdonald's advertisement in a language other than english	ইংরাজী ছাড়া অন্য ভাষায় ম্যাকডোনাল্ডের বিজ্ঞাপন
rolls of towels on stand	তোয়ালে রোল স্ট্যান্ডে
many glorious forms of opportunistic weeds	সুবিধাবাদী আগাছা অনেক গৌরবময় ফর্ম
kids at a fair eating	বাচ্চাদের ন্যায্য খাওয়ার সময়
a block lower half of a wall	একটি দেয়ালের নীচে অর্ধেক ব্লক
jelly jar on top of a chopping block	কাটা ব্লকের উপরে জেলি জার
yellow poles by the cross sign	ক্রস চিহ্ন দ্বারা হলুদ খুঁটি
orange time and date stamp	কমলা সময় এবং তারিখ স্ট্যাম্প
Two female tennis players shaking hands	দুই মহিলা টেনিস খেলোয়াড় হাত কাঁপছেন
A wooden stand	একটি কাঠের স্ট্যান্ড
Four baseball players on field.	মাঠে চার বেসবল খেলোয়াড়।
an American flag in the background of a press conference	একটি সংবাদ সম্মেলনের পটভূমিতে একটি আমেরিকান পতাকা
two english spaniels standing near a person	একজন ব্যক্তির কাছে দাঁড়িয়ে দুটি ইংলিশ স্প্যানিয়াল দাঁড়িয়ে
There is a book stand that is filled with books.	বইয়ের স্ট্যান্ড রয়েছে যা বই ভর্তি রয়েছে।
man taking pictures of players	মানুষ খেলোয়াড়দের ছবি তুলছে
Black hat with a red cross	একটি লাল ক্রস সঙ্গে কালো টুপি
three baseball players standing in a row	তিনটি বেসবল খেলোয়াড় একটি সারিতে দাঁড়িয়ে
A black and brown dog fast asleep on the couch.	একটি কালো এবং বাদামী কুকুর দ্রুত পালঙ্কে ঘুমিয়ে আছে।
the time stamp sitting in the corner	সময় স্ট্যাম্প কোণে বসে
yellow plane with characters	অক্ষরের সাথে হলুদ বিমান
Buttons for pedestrians to cross the street	রাস্তা পার হওয়ার জন্য পথচারীদের জন্য বোতাম t
A stand mixer	একটি স্ট্যান্ড মিশুক
this players is shirtless	এই খেলোয়াড়রা শার্ট ছাড়া আছে
pattern on side of second giraffe	দ্বিতীয় জিরাফ পাশের প্যাটার্ন
a block on the ground	মাটিতে একটি ব্লক
bicycles in stand	সাইকেল দাঁড়ানো
a man photographs two baseball players	একজন লোক দুই বেসবল খেলোয়াড়ের ছবি
a red don't cross signal.	একটি লাল ক্রস সংকেত না।
French coffee press	ফ্রেঞ্চ কফি প্রেস
black bicycle seat with supporting springs	সমর্থনকারী স্প্রিংস সহ কালো সাইকেল আসন
propeller is moving fast	প্রোপেলার দ্রুত এগিয়ে চলেছে
toy models of buses	খেলনা মডেল বাস
a motorcycle going fast	একটি মোটরসাইকেল দ্রুত যাচ্ছে
Shadow on the court	কোর্টে ছায়া
A brick wall separating players and spectators.	খেলোয়াড় এবং দর্শকদের পৃথককারী একটি ইটের প্রাচীর।
a fast moving hand	একটি দ্রুত চলন্ত হাত
The night stand is wooden.	নাইট স্ট্যান্ডটি কাঠের।
baseball players posing together in an old photograph	বেসবল খেলোয়াড়রা পুরানো ছবিতে একসাথে পোজ দিচ্ছেন
Net across tennis court	টেনিস কোর্ট জুড়ে নেট
glass top on night stand	নাইট স্ট্যান্ডে গ্লাস টপ
raised cross on top of remote control	রিমোট কন্ট্রোল শীর্ষে উত্থিত ক্রস
Grass growing on the grass tennis court.	ঘাস টেনিস কোর্টে বাড়ছে ঘাস।
time stamp on the picture	ছবিতে সময় স্ট্যাম্প
two red metal springs	দুটি লাল ধাতুর ঝর্ণা
a a block in a wall	একটি দেয়ালে একটি ব্লক
People looking to cross the road.	লোকেরা রাস্তা পার হতে দেখছে।
the fair sky	ফর্সা আকাশ
a motorcycle is parked in front of the road block	একটি মোটরসাইকেল রাস্তা ব্লকের সামনে দাঁড়িয়ে আছে
White striped pedestrian cross-walk painted on street.	রাস্তায় সাদা স্ট্রিপযুক্ত পথচারী ক্রস-ওয়াক আঁকা।
Baseball team players in the dugout	ডাগআউটে বেসবল দলের খেলোয়াড়রা
boy sitting cross legged	ছেলে টি হাঁটু ভাঁজ করে বসে
The man's hand forms a fist	লোকটির হাত মুঠো হয়েছে
stand of bamboo	বাঁশের স্ট্যান্ড
Statue honoring members of the armed forces	সশস্ত্র বাহিনীর সদস্যদের সম্মান জানিয়ে প্রতিমা
men of forces wearing the dress uniforms	ইউনিফর্ম পোষাক পরা পুরুষদের বাহিনী 
Another stand and its owner	আরেকটি স্ট্যান্ড এবং এর মালিক
A man stand next to a jeep.	একটা লোক জিপের পাশে দাঁড়িয়ে আছে।
The sign that says Alice springs	সাইন এ এলিস স্প্রিংস লেখা
a sandwich on a block	একটি ব্লকের উপর একটি স্যান্ডউইচ
red bags behind players feet	খেলোয়াড়দের পায়ের পিছনে লাল ব্যাগ
Asian characters on side of building	বিল্ডিংয়ের পাশে এশীয় অক্ষর
The tennis player's shadow is on the tennis court.	টেনিস কোর্টে টেনিস খেলোয়াড়ের ছায়া।
fast looking yellow motorcycle	দ্রুত গতির মোটর সাইকেল
white springs under bed	বিছানার নিচে সাদা স্প্রিংগুলো 
a sponsors name on the tennis court wall	টেনিস কোর্ট প্রাচীর একটি স্পনসর নাম
Asian characters written on a sign	একটি চিহ্নে লেখা এশীয় অক্ষর
the date and time indicating the time of picture	তারিখ এবং সময় ছবির সময় নির্দেশ করে
The light forms a rainbow	আলো একটি রংধনু গঠন করে
Headpiece of the second rider from the right	ডান থেকে দ্বিতীয় রাইডারের হেডপিস
postage stamp with liberty bell	ডাকটিকেটে লিবার্টি বেল
Mud forms along the edge of the watering hole	জলের পাশে কাদা হয়েছে
an unfinished block of wood	কাঠের একটি অসম্পূর্ণ ব্লক
green grass behind players	খেলোয়াড়দের পিছনে সবুজ ঘাস
the second base coach watches the play	দ্বিতীয় বেস কোচ খেলাটি দেখেন
child's soft fine brown hair	বাচ্চার নরম সূক্ষ্ম বাদামী চুল
A black entertainment stand on wheels	একটি কালো বিনোদন স্ট্যান্ড চাকার উপর দাঁড়িয়ে 
fast motion image of woman walking in rain	বৃষ্টিতে হাঁটা মহিলার দ্রুত গতির চিত্র
second story of building holds two balconies	বাড়ির দ্বিতীয় তলায় দুটি বারান্দা 
ovan kept in the stand	ওভান স্ট্যান্ডে রাখা
The speaker on the stand	স্ট্যান্ডে স্পিকার
a man in front of a produce stand	একটি পণ্য উত্পাদন স্ট্যান্ডের সামনে একজন মানুষ
a fast moving train	একটি দ্রুত চলন্ত ট্রেন
tennis players shadow on court	কোর্টে টেনিস খেলোয়াড়ের ছায়া 
date stamp on photo is 8/23/08	ছবিতে তারিখ স্ট্যাম্প 8/23/08 হয়
a man sitting on a cement block	একজন সিমেন্টের ব্লকে বসে আছেন
several baseball players in the dugout	ডাগআউটে বেশ কয়েকটি বেসবল খেলোয়াড়
An orange time stamp	কমলা রঙের তারিখ স্ট্যাম্প 
the date is orange	তারিখ টি কমলা রঙের 
Grey block wall behind woman	মহিলার পিছনে ধূসর ব্লক প্রাচীর
english muffin with egg and hollandaise	ডিম এবং হল্যান্ডাইজের সাথে ইংলিশ মাফিন
tail of elephant forms a circle	হাতির লেজ একটি বৃত্ত গঠন করে
plant is on a metal stand	ধাতব স্ট্যান্ডের উপর গাছ
stand for trays	ট্রে এর স্ট্যান্ড 
this is a blue court	এটি একটি নীল কোর্ট
ginger with fair skin, orange hair, billions of freckles, and glasses	ফর্সা ত্বক, কমলা চুল, কোটি কোটি ফ্রিকলস এবং চশমাযুক্ত প্রানবন্ত ভাব 
facial expression, particularly mouth that says, 'yeah, i'm fine w/ being a corporate drone	মুখের অভিব্যক্তি, বিশেষত মুখটি বলে যে 'হ্যাঁ, আমি বড় কোম্পানির কর্মচারী হয়ে ভাল আছি' 
white block on the street	রাস্তায় সাদা ব্লক
boat forms ripples	নৌকা লহর ফর্ম
child forces straws into a a can	বাচ্ছাটি জোর করে ক্যান এর ভেতরে স্ট্র পুশ করে
Blue square on tennis court	টেনিস কোর্টে ব্লু স্কয়ার
the players tennis shoes are white	খেলোয়াড়দের টেনিস জুতো সাদা
sign denoting 2900 block	2900 ব্লকটি চিহ্নিত করুন sign
books in a black stand	একটি কালো স্ট্যান্ড বই
date and time of picture	তারিখ এবং ছবির সময়
a train stop block	একটি ট্রেন স্টপ ব্লক
Snow covered cross walk	তুষার ঢাকা ক্রস ওয়াক
the steeple has a cross on top	স্টিপলের উপরে একটি ক্রস রয়েছে
Soccer players in action	অ্যাকশনে সকার খেলোয়াড়রা
tennis court in bounds area for doubles play	ডাবল খেলার জন্য সীমান্ত অঞ্চলে টেনিস কোর্ট
english word in green	সবুজ ইংরেজি শব্দ
Brown tennis court with white lines.	সাদা লাইনে ব্রাউন ব্র্যান্ডের টেনিস কোর্ট।
A brown stand next to a wall.	একটি দেয়ালের পাশে একটি বাদামী স্ট্যান্ড।
black iron gate with white cross	সাদা ক্রস সঙ্গে কালো লোহার গেট
time stamp with red number	লাল নম্বর সহ সময় স্ট্যাম্প
stack of books on bed stand	বিছানা স্ট্যান্ড বইয়ের স্তুপ
knife set in a wooden block	একটি কাঠের ব্লক মধ্যে ছুরি সেট
base ball diamond with players	খেলোয়াড়দের নিয়ে বেসবল ডায়মন্ড
Television in the tv stand.	টিভি স্ট্যান্ডে টেলিভিশন।
second green sign from the top	উপরে থেকে দ্বিতীয় সবুজ চিহ্ন
Date stamp 6/30/2013	তারিখ স্ট্যাম্প 6/30/2013
logo on the tennis court	টেনিস কোর্টে লোগো
the necktie has a circle cross motif	নেকটি একটি বৃত্ত ক্রস মোটিফ আছে
a photographers stamp on the photo	ছবির উপর একটি ফটোগ্রাফার স্ট্যাম্প
block of green water in front of surfer	সার্ফারের সামনে সবুজ জলের ব্লক
asian characters in red	লাল এশিয়ান অক্ষর
A fine white sand	একটি সূক্ষ্ম সাদা বালি
night stand made of dark brown wood	গাঢ় বাদামী কাঠের তৈরি নাইট স্ট্যান্ড
two players in ground	মাটিতে দুই খেলোয়াড়
brown mane on neck of second giraffe	দ্বিতীয় জিরাফের গলায় বাদামি কেশর
white engraved cross	সাদা খোদাই করা ক্রস
Red and silver sign with Asian characters	এশীয় অক্ষরগুলির সাথে লাল এবং রৌপ্য সাইন
Woman getting ready to cross street	মহিলা রাস্তায় পার হতে প্রস্তুত
press board table top	টেবিলের উপর প্রেসবোর্ড
the train is a fast speed train	একটি দ্রুত গতির ট্রেন
People at a fair.	মেলায় লোকজন।
a metal cross beam	একটি ধাতব ক্রসবিম
players are playing baseball.	খেলোয়াড়রা বেসবল খেলছে।
railed porch on the second floor of a home	একটি বাড়ির দ্বিতীয় তলায় বারান্দা 
Balconies on the second floor	দ্বিতীয় তলায় বালকিনিগুলি
a plate with white characters	সাদা অক্ষরযুক্ত একটি প্লেট
The players wear uniforms.	খেলোয়াড়রা ইউনিফর্ম পরে।
photographers watermark and date	ফটোগ্রাফারদের জলছবি এবং তারিখ
Red table with fast food above it	এর উপরে ফাস্ট ফুড সহ লাল টেবিল
woman cross her arms	মেয়েটি হাত ভাঁজ করে
The tracks cross here	ট্র্যাকগুলি এখানে পার হয়
"orange ""do not cross"" sign"	"কমলা ""ক্রস করবেন না"" চিহ্ন"
A person standing at the food stand.	খাবার স্ট্যান্ডে দাঁড়িয়ে একজন ব্যক্তি।
Three players are wearing helmet.	তিনজন খেলোয়াড় হেলমেট পরেছেন।
a non english sign	একটি অ ইংরেজী সাইন
player running on court	খেলোয়াড় কোর্টে চলছে
the woman on the court	কোর্টে মহিলা
A round concert block	একটি বৃত্তাকার কনসার্ট ব্লক
fast food items on plates	প্লেটগুলিতে ফাস্ট ফুড আইটেম
Top window pane in the left corner of the second story window	দ্বিতীয় গল্পের উইন্ডোর বাম কোণে শীর্ষ উইন্ডো ফলক
boundary lines on court	কোর্টে সীমানা লাইন
second wooden vertical slat from left	বাম থেকে দ্বিতীয় কাঠের উল্লম্ব স্লট
A stand of trees along the edge of the lake	হ্রদের কিনারায় গাছের স্ট্যান্ড
a blue and white cross walk sign	একটি নীল এবং সাদা ক্রস ওয়াক সাইন
open door of a second bus	দ্বিতীয় বাসের দরজা খোলা
floral box springs under mattress	গদি অধীনে ফুলের বক্স স্প্রিংস
street sign advising of penalty	রাস্তার সাইন জরিমানার পরামর্শ
oranges and pears on the second layer of a fruit tree rack	একটি ফলের গাছের র্যাকের দ্বিতীয় স্তরে কমলা এবং নাশপাতি
A skier going down fast on a slope	একজন ierালুতে দ্রুত নেমে একটি স্কাইয়ার
an english saddle above a saddle pad	একটি স্যাডল প্যাডের উপরে একটি ইংরেজী স্যাডল
four shadowy forms of giraffes seemingly looking forward	জিরাফের চারটি ছায়াময় রূপগুলি আপাতদৃষ্টিতে অপেক্ষা করছে
dirty concrete wall behind players	খেলোয়াড়দের পিছনে নোংরা কংক্রিট প্রাচীর
a couple of elephants photoshopped to stand out	বাইরে দাঁড়িয়ে বেশ কয়েকটি হাতির ফটোশপ করলেন
The fast moving subway train	দ্রুত চলমান সাবওয়ে ট্রেন
the net between the two players	দুই খেলোয়াড়ের মধ্যে নেট
Baseball glove on players left hand	খেলোয়াড়দের বাম হাতে বেসবল গ্লোভ
silver and black french coffee press on shelf	বালুচর উপর সিলভার এবং কালো ফরাসি কফি প্রেস
grey block in sidewalk	ফুটপাতে ধূসর ব্লক
short tan entertainment stand	সংক্ষিপ্ত ট্যান বিনোদন স্ট্যান্ড
A wooden block holding up the boat	একটি কাঠের ব্লক যা নৌকাকে চেপে ধরে
fence next to players	খেলোয়াড়দের পাশে বেড়া
Oranges on a fruit stand	ফলের স্ট্যান্ডে কমলা
a butcher block with knives	ছুরি দিয়ে কসাই ব্লক
Cluttered night stand	বিশৃঙ্খলা নাইট স্ট্যান্ড
tan house with lighter colored second floor	হালকা রঙ্গিন দ্বিতীয় তল সঙ্গে ট্যান ঘর
two white chairs on tennis court	টেনিস কোর্টে দুটি সাদা চেয়ার
a cross railway sign	একটি ক্রস রেলওয়ে সাইন
a triangle forms on brick	একটি ত্রিভুজ ইট উপর ফর্ম
A fast boat with people in it	এতে লোকজনের সাথে একটি দ্রুত নৌকা
People waiting to cross street.	রাস্তা পার হওয়ার অপেক্ষায় থাকা মানুষ।
the button to press for the light is below the signal	আলোর জন্য চাপতে বোতামটি সিগন্যালের নীচে
dirt ground elephants stand on	ময়লা গ্রাউন্ড হাতি দাঁড়িয়ে আছে
the springs on the motorcycle	মোটরসাইকেলের ঝর্ণা
marked pedestrian cross walk	পথচারী ক্রস ওয়াক চিহ্নিত
The water is flowing fast	জল দ্রুত প্রবাহিত হয়
The word AUG in the date	তারিখের এওজি শব্দটি
wooden slat that forms back of bench.	কাঠের স্লট যা বেঞ্চের পিছনে গঠন করে।
the two male players are after the ball	দুই পুরুষ খেলোয়াড় বল পরে আছেন
power lines cross in the air	শক্তি লাইন বাতাসে অতিক্রম
area next to pot stand	পট স্ট্যান্ডের পাশের অঞ্চল
fast food in the backgrond	ব্যাকগ্রাউন্ডে ফাস্টফুড
this is a concrete yellow block	এটি একটি কংক্রিট হলুদ ব্লক
shadow on tennis court.	টেনিস কোর্টে ছায়া।
tennis court marked with white color	টেনিস কোর্ট সাদা রঙের সাথে চিহ্নিত
a green Christmas tree stand	সবুজ ক্রিসমাস ট্রি স্ট্যান্ড
a business man waiting to cross the street	একজন ব্যবসায়ী লোক রাস্তা পার হওয়ার অপেক্ষায়
A white stand mixer	একটি সাদা স্ট্যান্ড মিশুক
The time stamp is red.	সময় স্ট্যাম্প লাল।
cross section of a broccoli stem	একটি ব্রোকলি স্টেম ক্রস বিভাগ
players in the dugout.	খেলোয়াড়
a green fence at a tennis court	টেনিস কোর্টে সবুজ বেড়া
person playing tennis on the court	ব্যক্তি কোর্টে টেনিস খেলছে
Man trying to block the throwing of a frisbee	মানুষ একটি ফ্রিসবি নিক্ষেপ করার চেষ্টা করছে
the balcony on the second floor	দ্বিতীয় তলায় বারান্দা
Red dragon fruit on a fruit stand.	একটি ফলের স্ট্যান্ডে লাল ড্রাগন ফল।
person setting in second seat of bus	ব্যক্তি বাসের দ্বিতীয় সিটে বসছে
The body of the stand up lamp.	দেহের স্ট্যান্ড আপ ল্যাম্প।
The players are male.	খেলোয়াড়রা পুরুষ।
A fence at a tennis court	টেনিস কোর্টে একটি বেড়া
the date says 7-1	তারিখটি 7-1 বলে
picture hanging in the wall with anime characters	এনিমে অক্ষরগুলির সাথে দেয়ালে ঝুলন্ত ছবি
a grill press	একটি গ্রিল প্রেস
Bird models suspended in shopping mall.	শপিং মলে বার্ড মডেলগুলি স্থগিত করা হয়েছে।
green wall on tennis court	টেনিস কোর্টে সবুজ প্রাচীর
Woman in an english style saddle	মহিলা একটি ইংলিশ স্টাইলের স্যাডলে
Photo date stamp	ছবির তারিখ স্ট্যাম্প
the copyright and date stamp of the photographer	ফটোগ্রাফারের কপিরাইট এবং তারিখ স্ট্যাম্প
a man stand on dock	একজন লোক ডকের উপরে দাঁড়িয়ে আছে
two players wearing white shorts	সাদা শর্টস পরা দুই খেলোয়াড়
People on the court playing tennis.	টেনিস খেলে কোর্টে লোকেরা।
A blue fine on the surf board.	সার্ফ বোর্ডে একটি নীল জরিমানা।
White potted flowers on the tennis court	টেনিস কোর্টে সাদা পাত্র ফুল
a toasted english muffin	একটি টোস্টড ইংলিশ মাফিন
Baseball player stealing second base	বেসবল খেলোয়াড় দ্বিতীয় বেস চুরি
a date stamp for 2010/02/07	2010/02/07 এর জন্য একটি তারিখ স্ট্যাম্প
second story of house	বাড়ির দ্বিতীয় গল্প
Blue cross window on second floor	দ্বিতীয় তলায় নীল ক্রস উইন্ডো
bird characters on top of a brown cake	একটি বাদামী পিষ্টকের উপরে পাখির অক্ষর
a advertisement for highland springs	পার্বত্য অঞ্চলের ঝর্ণা জন্য একটি বিজ্ঞাপন
the tennis court is made of grass	টেনিস কোর্ট ঘাস দিয়ে তৈরি
a line of runway models	রানওয়ে মডেলগুলির একটি লাইন
yellow numbers showing the date	হলুদ সংখ্যা তারিখ দেখাচ্ছে
A women skiing fast.	একজন মহিলা দ্রুত স্কিইং করছেন।
cross country ski racers skiing up a hill.	ক্রস কান্ট্রি স্কি রেসাররা একটি পাহাড়ের উপরে স্কিইং করছে।
Three women soccer players sitting on a bench.	তিনজন মহিলা ফুটবল খেলোয়াড় একটি বেঞ্চে বসে।
decaying amazing building that looks like something between an aztec and buddhist shrine in the english countryside	ক্ষয়িষ্ণু বিস্ময়কর বিল্ডিং যা দেখতে ইংরাজির পল্লীতে অ্যাজটেক এবং বৌদ্ধবাদী মাজারের মাঝে কিছু মনে হচ্ছে
A pot is fitted in a stand.	একটি স্ট্যান্ডে একটি পাত্র লাগানো হয়।
Safety railing on second story of building	বিল্ডিংয়ের দ্বিতীয় গল্পের সুরক্ষা রেলিং
Man sits floor cross legged	মানুষ মেঝে ক্রস পায়ে বসে
White writing on a blue court.	নীল দরবারে সাদা লেখা।
a very fast baseball	খুব দ্রুত বেসবল
White clock face with brown characters	বাদামী বর্ণের সাথে সাদা ঘড়ির মুখ
buildings are behind the road block	রোড ব্লকের পিছনে ভবনগুলি
Young woman in grey sweatshirt hoping to block frisbee.	ফ্রিসবি ব্লক করার আশায় ধূসর সোয়েটশার্টে যুবতী।
people on the second floor	দ্বিতীয় তলায় মানুষ
a red dirt tennis court	একটি লাল ময়লা টেনিস কোর্ট
Black block with number on it	এটিতে নম্বর সহ ব্লক ব্লক
stuffed disney characters	স্টাফ ডিজনি অক্ষর
players waiting in dugout	খেলোয়াড় dugout মধ্যে অপেক্ষা
baseball players white pants	বেসবল খেলোয়াড় সাদা প্যান্ট
A motorcycle kick stand.	একটি মোটরসাইকেলের কিক স্ট্যান্ড।
There is some fine sand here	এখানে কিছু সূক্ষ্ম বালি আছে
a metal orange juice press	একটি ধাতব কমলা রস প্রেস
a baseball players uniform	একটি বেসবল খেলোয়াড় ইউনিফর্ম
Three baseball players on baseball field.	বেসবল মাঠে তিন বেসবল খেলোয়াড়।
Booths at a street fair.	রাস্তার মেলায় বুথ।
Back right foot of the second goat	দ্বিতীয় ছাগলের ডান পা পিছনে
fine toothed blade of knife	ছুরি জরিমানা দাঁতযুক্ত ফলক
guy's hand trying to block the camera	লোকটির হাত ক্যামেরাটি ব্লক করার চেষ্টা করছে
Baseball in players right hand	খেলোয়াড়দের ডান হাতে বেসবল
The second highest rail of the jump	লাফের দ্বিতীয় সর্বোচ্চ রেল
a white paper not in english	একটি সাদা কাগজ ইংরেজি না
green and white concession stand near umbrella	ছাতার কাছাকাছি সবুজ এবং সাদা ছাড়
metal stand for ropes	দড়ি দড়ি জন্য স্ট্যান্ড
an umbrella standing in a tennis court	টেনিস কোর্টে একটি ছাতা দাঁড়িয়ে আছে
there are english and Chinese characters	ইংরেজি এবং চীনা অক্ষর আছে
a bench along a tennis court	টেনিস কোর্ট বরাবর একটি বেঞ্চ
a young girl with a fair complexion	একটি ফর্সা বর্ণের সঙ্গে একটি যুবা মেয়ে
The players uniform is white	খেলোয়াড়দের ইউনিফর্ম সাদা
a motorcycle side stand	মোটরসাইকেলের সাইড স্ট্যান্ড
The second clock showing on the tower.	টাওয়ারে দেখানো দ্বিতীয় ঘড়ি।
tennis court floor	টেনিস কোর্ট ফ্লোর
cross on top of steeple	স্টেপল উপর ক্রস
the players are on a field	খেলোয়াড়রা একটি মাঠে আছে
the second car in the train	ট্রেনের দ্বিতীয় গাড়ি
A TV stand sitting under TV	টিভির নিচে বসে একটি টিভি স্ট্যান্ড
two young softball players sitting on the bench	দুই তরুণ সফটবল খেলোয়াড় বেঞ্চে বসে আছেন
man on a tennis court on a sunny day	টেনিস কোর্টে এক রোদ রোজ মানুষ
mass sheep and woolcraft fair ribbon	ভর মেষ এবং উলক্রাফট মেলা ফিতা
the combs are fine	ঝুঁটি ভাল আছে
cap on players head	খেলোয়াড়দের মাথায় ক্যাপ
the models are red and black	মডেলগুলি লাল এবং কালো
Green and red tennis court	সবুজ এবং লাল টেনিস কোর্ট
a celtic cross stone monument	একটি সেল্টিক ক্রস পাথর স্মৃতিস্তম্ভ
plants behind toy models	খেলনা মডেল পিছনে গাছপালা
wave is moving fast	তরঙ্গ দ্রুত গতিতে চলছে
red double decker bus with Chinese characters and number 8	চীনা অক্ষর এবং 8 নম্বর সহ লাল ডাবল ডেকার বাস
this shop sells fine ales	এই দোকান জরিমানা বিক্রি করে
orange street block	কমলা স্ট্রিট ব্লক
cross section of fans at baseball game	বেসবল খেলায় ভক্তদের ক্রস বিভাগ
large soft drink cup from a fast food restaurant or store	একটি ফাস্ট ফুড রেস্তোঁরা বা স্টোর থেকে বড় সফট ড্রিঙ্ক কাপ
red bananas at a fruit stand	একটি ফল স্ট্যান্ডে লাল কলা
train moving fast blurring image	দ্রুত চলা ট্রেনের ঝাপসা ছবি
this sign is not in english	এই চিহ্নটি ইংরেজিতে নেই
an apple cider press	একটি আপেল সিডার প্রেস
Black tv on top of brown stand.	ব্রাউন স্ট্যান্ডের উপরে কালো টিভি।
a hand moving too fast for the camera	একটি হাত ক্যামেরার জন্য খুব দ্রুত গতিতে চলেছে
Starps on the stand.	স্ট্যান্ডের উপর স্ট্র্যাপ্গুলো
medium brown wood fine grained table	মাঝারি বাদামী কাঠ সূক্ষ্ম দানযুক্ত টেবিল
Back of court is green.	কোর্টের পিছনে সবুজ।
white trail that can only be made by incredibly fast planes	সাদা ট্রেইল যা কেবল অবিশ্বাস্যভাবে দ্রুত প্লেন দ্বারা তৈরি করা যায়
score card being held by a man on tennis court	টেনিস কোর্টে একজন লোক দ্বারা স্কোর কার্ড রাখা হচ্ছে
Man seated at food court table	মানুষ ফুড কোর্টের টেবিলে বসে আছে
black cap on players head	খেলোয়াড়দের মাথায় ব্ল্যাক ক্যাপ
sydney written in white letters on court	সিডনি কোর্টে সাদা অক্ষরে লেখা
fine whiskers on animal's chin	পশুর চিবুক উপর সূক্ষ্ম চুল
a green chair on a tennis court	টেনিস কোর্টে একটি সবুজ চেয়ার
Dollar amount of the penalty.	জরিমানার ডলার পরিমাণ।
Baseball catcher watching players	খেলোয়াড়দের দেখছেন বেসবল ক্যাচার
white Arabic characters on sign	সাইন ইন সাদা আরবী অক্ষর
poster with cartoon characters	কার্টুন চরিত্রযুক্ত পোস্টার
A time date stamp in the corner	কোণে একটি সময় তারিখ স্ট্যাম্প
window planters outside second story	দ্বিতীয় তলের বাইরে উইন্ডো রোপনকারীরা
green floor next to court	কোর্টের পাশের সবুজ তল
The boy has a orange stamp on his hand.	ছেলেটির হাতে কমলা স্ট্যাম্প রয়েছে।
black mit in players hand	খেলোয়াড়দের হাতে কালো এমআইটি
cross next to the clock tower	ঘড়ির টাওয়ারের পাশ দিয়ে পার
sheep running really fast	মেষ সত্যিই দ্রুত চলমান
advertising to the state fair is mounted on the lamp post	রাষ্ট্র মেলায় বিজ্ঞাপন প্রদীপ পোস্টে লাগানো হয়
bed pillow with cartoon characters on it	এটিতে কার্টুন চরিত্রগুলি সহ বিছানার বালিশ
tennis court being used in a match	টেনিস কোর্ট একটি ম্যাচ ব্যবহার করা হচ্ছে
Knives in wood block	কাঠের ব্লকে ছুরি
part of the ball field with players getting ready to play	খেলোয়াড়দের খেলতে প্রস্তুত হয়ে বল মাঠের একটি অংশ
the weather is fair	আবহাওয়া ভাল
cement block siding on church	গির্জার উপর সিমেন্ট ব্লক সাইডিং
a man in the armed forces	সশস্ত্র বাহিনীর একজন
The car is moving fast.	গাড়ি দ্রুত এগিয়ে চলেছে।
block wall behind giraffe head	জিরাফ মাথার পিছনে প্রাচীর ব্লক
yellow stand	হলুদ স্ট্যান্ড
chinese characters are in the sign	চীনা অক্ষর চিহ্ন আছে
the seat of the second motorcycle	দ্বিতীয় মোটরসাইকেলের সিট
Green part of a tennis court.	টেনিস কোর্টের সবুজ অংশ।
the wave moves fast	তরঙ্গ দ্রুত চলে আসে
White second hand on the clock.	ঘড়িতে সাদা সেকেন্ডের কাঁটা
green colored material separating the court	সবুজ রঙের জিনিস দিয়ে কোর্টটি আলাদা করা আছে
The traffic lights stand out a lot.	অনেকগুলো ট্রাফিক লাইট
fine stitching on leash	চেন এর উপর সূক্ষ্ম সেলাই
Kick stand on a motorcycle.	একটি মোটরসাইকেলের কিকস্টান্ড
An electronic display showing the date	একটি বৈদ্যুতিন প্রদর্শন তারিখটি দেখায়
cement block facade on a building	একটি বিল্ডিং সিমেন্ট ব্লক সম্মুখের
person forces cow to ramble over rocks for unknown reason	ব্যক্তি অজানা কারণে গাভীকে পাথরের উপরে চলাফেরা করতে বাধ্য করে
a cross walk across street white pattern	রাস্তার সাদা প্যাটার্ন জুড়ে ক্রস ওয়াক
two lemons together on a block	একটি ব্লকে দুটি লেবু একসাথে
white teeth-like forms on top of wing	ডানা উপরে সাদা দাঁত মত ফর্ম
date in red letters and numerals	লাল বর্ণ এবং সংখ্যাগুলিতে তারিখ
empire near second base	দ্বিতীয় বেস কাছাকাছি সাম্রাজ্য
second place is wearing yellow	দ্বিতীয় স্থান হলুদ পরা হয়
man in the middle of tennis court	টেনিস কোর্টের মাঝখানে মানুষ
The second sign says 4 way.	দ্বিতীয় চিহ্নটি 4 উপায় বলে।
five wheels on the court	কোর্টে পাঁচ চাকা
Red T-shirt with white cross patch	সাদা ক্রস প্যাচ সহ লাল টি-শার্ট
small white rocking chair with mother and child models in it	এতে মা ও শিশুদের মডেল সহ ছোট ছোট দোলের চেয়ার
The comb is fine toothed.	চিরুনিটি দাঁতযুক্ত is
date stamp on the photo	ছবির উপর তারিখ স্ট্যাম্প
Chinese characters on the sign	সাইন ইন চীনা অক্ষর
The sky is fair.	আকাশটা ফর্সা।
a green court	সবুজ কোর্ট
a woman walking throw a trade fair	একজন মহিলা হাঁটছেন একটি বাণিজ্য মেলা
A crowd of people standing at the fair.	মেলায় দাঁড়িয়ে মানুষের ভিড়।
a man standing on court	একজন লোক কোর্টে দাঁড়িয়ে
cross on a building	একটি বিল্ডিং উপর ক্রস
the players shoes have spikes	প্লেয়ার জুতা স্পাইক আছে
A large brown block.	একটি বড় বাদামী ব্লক।
Man skiing fast	ম্যান দ্রুত স্কিইং
the person has fair skin	ব্যক্তির ফর্সা ত্বক আছে
Skid foot marks on a tennis court	টেনিস কোর্টে স্কিড পায়ের চিহ্ন
a woman in a fair isle sweater	ফর্সা আইল সোয়েটারের এক মহিলা
Shadow on the ground of the second racket from the left	বাম দিক থেকে দ্বিতীয় র‌্যাকেটের মাটিতে ছায়া
A backwards baseball hat on the players head.	খেলোয়াড়দের মাথার পিছনে একটি বেসবল টুপি।
a watermark and date	একটি জলছবি এবং তারিখ
the toys are on the stand	খেলনা স্ট্যান্ডে আছে
a second statue of a cow	একটি গরুর দ্বিতীয় মূর্তি
large crack in tennis court	টেনিস কোর্টে বড় ফাটল
The white ice models in the room.	ঘরে সাদা বরফের মডেল।
hairy arm with fair pale skin	ফর্সা ফ্যাকাশে ত্বক সঙ্গে লোমশ বাহু
Paper on night stand	নাইট স্ট্যান্ডে কাগজ
date stamp that reads 12/04/2010	তারিখ স্ট্যাম্প যা 12/04/2010 পড়বে
Yellow criss cross on the street by train.	ট্রেনে রাস্তায় হলুদ ক্রাইসস অতিক্রম করে।
base ball opponent players	বেস বল প্রতিপক্ষের খেলোয়াড়
three baseball players playing a game	তিনটি বেসবল খেলোয়াড় একটি খেলা খেলছে
The white bins on the second shelf of the fridge.	ফ্রিজের দ্বিতীয় তাকের সাদা পাতাগুলি।
fine texture of feathers	পালকের সূক্ষ্ম জমিন
large orange and green sign giving name and date	নাম এবং তারিখ প্রদত্ত বড় কমলা এবং সবুজ চিহ্ন
green cross on top of building	বিল্ডিংয়ের উপরে সবুজ ক্রস
colorful bus parked next to a stand and umbrella	স্ট্যান্ড এবং ছাতার পাশেই পার্কিং রঙিন বাস
a purple umbrella with little cartoon characters	ছোট্ট কার্টুন চরিত্র সহ একটি বেগুনি ছাতা
the date is shown on the outter portion	তারিখটি বহির্মুখী অংশে প্রদর্শিত হয়
fast moving ball towards home plate	হোম প্লেটের দিকে দ্রুত চলমান বল
a fast food ordering bar	একটি ফাস্ট ফুড অর্ডার বার
The date 02/10/2009.	তারিখ 02/10/2009।
train going by fast	দ্রুত যেতে ট্রেন
date and time stamp	তারিখ এবং সময় স্ট্যাম্প
person has fair colored skin	ব্যক্তির ফর্সা বর্ণের ত্বক থাকে
the copyright stamp on the photo	ছবির কপিরাইট স্ট্যাম্প
grey fine toothed comb	ধূসর জরিমানা দাঁতযুক্ত ঝুঁটি
pizza on a butcher block table	কসাই ব্লক টেবিলে পিজ্জা
gold Chinese characters on a red flag	একটি লাল পতাকায় স্বর্ণের চীনা অক্ষর
The date stamp on the photo.	ছবির উপর তারিখ স্ট্যাম্প।
red and white cross on man's shoulder	মানুষের কাঁধে লাল এবং সাদা ক্রস
second bird is standing on car	দ্বিতীয় পাখি গাড়িতে দাঁড়িয়ে আছে
white lines painted on court	সাদা লাইন কোর্টে আঁকা
A tennis court has snow on the surface	একটি টেনিস কোর্টের তলদেশে বরফ রয়েছে
a metal stand under the seat of a bench	একটি বেঞ্চের সিটের নীচে একটি ধাতব স্ট্যান্ড
a railing forms a corner sitting area	একটি রেলিং কোণার বসার অঞ্চল গঠন করে
boy sitting cross-legged on ground	ছেলেটি মাটিতে ক্রস লেগে বসে আছে
date and hotel that the photo was taken	তারিখ এবং হোটেল যে ছবি তোলা হয়েছিল
fine china with flower design	ফুলের নকশা সহ সূক্ষ্ম চীন
green field next to players	খেলোয়াড়দের পাশে সবুজ ক্ষেত্র
black metal cross-walk light	কালো ধাতব ক্রস ওয়াক আলো
a lone spectator behind the tennis players	টেনিস খেলোয়াড়দের পিছনে একাকী দর্শক
the picture has a date stamp	ছবিটিতে একটি তারিখের স্ট্যাম্প রয়েছে
Calendar has star wars characters on it	ক্যালেন্ডারে এতে তারকা যুদ্ধের অক্ষর রয়েছে
spectator seats at a tennis court	টেনিস কোর্টে দর্শকের আসন
a hard true tennis court	একটি কঠিন সত্য টেনিস কোর্ট
Grate over a concrete block	একটি কংক্রিট ব্লকের উপর কষান
foreign characters on the vehicle's side	গাড়ির পাশে বিদেশী অক্ষর
wood platform for bird to stand on	পাখি দাঁড়িয়ে জন্য কাঠের প্ল্যাটফর্ম
Woman going fast downhill.	মহিলা দ্রুত উতরাইয়ের দিকে যাচ্ছে।
second floor windows	দ্বিতীয় তলার জানালা
second red and blue train	দ্বিতীয় লাল এবং নীল ট্রেন
White lamp shade on tall stand	লম্বা স্ট্যান্ডে সাদা ল্যাম্প শেড
fast pass tickets on bus window	বাসের জানালায় দ্রুত পাসের টিকিট
an english style toilet	একটি ইংরেজি স্টাইল টয়লেট
Large models in the park field	পার্ক মাঠে বড় মডেল
chair is decorated with Disney characters	চেয়ার ডিজনি অক্ষর সজ্জিত
knife on the chopping block	কাটা ব্লকের উপর ছুরি
A bed of steel springs	স্টিলের ঝর্ণার একটি বিছানা
this is a fast food place	এটি একটি ফাস্ট ফুডের জায়গা
beige table lamp on stand	স্ট্যান্ডে বেইজ টেবিল ল্যাম্প
the tennis court	টেনিস কোর্ট
trunk of elephant forms a C	হাতির ট্রাঙ্ক একটি সি গঠন করে
food on english muffin with yellow sauce	হলুদ সসের সাথে ইংলিশ মাফিনে খাবার
This part of the court is blue	কোর্টের এই অংশটি নীল
an attraction for a fair	একটি মেলা জন্য আকর্ষণ
blue box on tennis court	টেনিস কোর্টে ব্লু বক্স
black metal plant stand	কালো ধাতব উদ্ভিদ স্ট্যান্ড
the players hanging out in the dugout	খেলোয়াড়রা হতাশায় ঝুলছে
Base of the yellow umbrella second from the left	বাম থেকে দ্বিতীয় হলুদ ছাতা বেস
the black fast forward arrow	কালো দ্রুত এগিয়ে তীর
Orange color night lamp with wooden stand	কাঠের স্ট্যান্ড সহ কমলা রঙের নাইট ল্যাম্প
line where block fit together	ব্লক যেখানে একসাথে ফিট
bat stand in middle of bats	ব্যাট ব্যাট এর মাঝখানে
doilee stand is silver	দোয়েলি স্ট্যান্ড সিলভার is
person on the court wearing black shirt	কোর্টে কালো শার্ট পরা ব্যক্তি
different plane models are seen.	বিভিন্ন বিমানের মডেল দেখা যায়।
Two press buttons of the sweater	সোয়েটারের দুটি প্রেস বোতাম
Time and date stamp in corner	কোণে সময় এবং তারিখ স্ট্যাম্প
The stand of the t.v.	T.v. এর স্ট্যান্ড
sharp knife on the chopping block	কাটা ব্লকের উপর ধারালো ছুরি
second bird on right	ডানদিকে দ্বিতীয় পাখি
woman wearing dress about to cross street	রাস্তায় পার হওয়ার জন্য পোশাক পরা মহিলা
two motor cycle springs	দুটি মোটর চক্র স্প্রিংস
a lava lamp on stand	স্ট্যান্ডে একটি লাভা বাতি
black springs	কালো ঝর্ণা
a mirror on a stand	একটি স্ট্যান্ডে একটি আয়না
green grass as tennis court	টেনিস কোর্ট হিসাবে সবুজ ঘাস
antique golf clubs and stand	প্রাচীন গল্ফ ক্লাব এবং স্ট্যান্ড
wheels of train with springs	স্প্রিংস সঙ্গে ট্রেন চাকা
clear plastic French press	পরিষ্কার প্লাস্টিক ফ্রেঞ্চ প্রেস
fine brown dirt	সূক্ষ্ম বাদামী ময়লা
lifeguard stand is blue and white	লাইফগার্ড স্ট্যান্ড নীল এবং সাদা
fast food	ফাস্ট ফুড
a red cross on the paper	কাগজে একটি রেড ক্রস
a fast food meal served on a white plate	একটি ফাস্ট প্লেট একটি সাদা প্লেটে পরিবেশন করা
Dirt is on the baseball players outfit	গ্লাসটি বেসবল খেলোয়াড়দের পোশাকে রয়েছে
A cinder block wall.	একটি সিন্ডার ব্লক প্রাচীর।
Man playing tennis on purple and green tennis court.	ম্যান বেগুনি এবং সবুজ টেনিস কোর্টে টেনিস খেলছেন।
Cartoon characters on his shirt	তার শার্টে কার্টুন চরিত্রগুলি
black TV stand with flat screen	ফ্ল্যাট পর্দা সঙ্গে কালো টিভি স্ট্যান্ড
Some people are at the county fair	কিছু লোক কাউন্টি মেলায় আছেন
charger stand on a desk	চার্জার একটি ডেস্ক স্ট্যান্ড
security forces vehicle with open windows	নিরাপত্তা বাহিনী খোলা জানালা দিয়ে যানবাহন
Staircase leading to the second floor	সিঁড়ি দ্বিতীয় তলায় এগিয়ে
a stand of snow covered trees	বরফ ঢাকা গাছের একটি স্ট্যান্ড
Three different cellphone models	তিনটি পৃথক সেলফোন মডেল
this is the cross	এই ক্রস হয়
hedge bush growing outside of the tennis court	টেনিস কোর্টের বাইরে হেজ বুশ বাড়ছে
a fine skateboard	একটি দুর্দান্ত স্কেটবোর্ড
the trees in the tennis court	টেনিস কোর্টে গাছ
wood cross	কাঠ ক্রস
a knife block on the shelf	বালুচর উপর একটি ছুরি ব্লক
line of trees to the left of the court	কোর্টের বামে গাছের লাইন
surfer stand a surfboard	surfer একটি surfboard স্ট্যান্ড
date book with plastic cover	প্লাস্টিকের কভার সহ তারিখের বই
a stamp in the wood	কাঠ একটি স্ট্যাম্প
yellow time and date stamp	হলুদ সময় এবং তারিখ স্ট্যাম্প
some kind of festival or fair	কোন এক উত্সব বা মেলা
gate/door to fence surrounding court	দরজার আশেপাশে বেড়া দরজা / দরজা
The bench the players are sitting on.	খেলোয়াড়রা বসে আছেন বেঞ্চে।
Helmet on the second horse rider.	দ্বিতীয় ঘোড়সওয়ারে হেলমেট
poles that block entrance by large vehicles	বড় বড় যানবাহন দিয়ে খুঁটিগুলি প্রবেশ পথ আটকে দেয়
black shadow on baseball field beneath baseball players feet	বেসবল খেলোয়াড়দের পায়ের নীচে বেসবল মাঠে কালো ছায়া
sign on brass stand	পেতলের স্ট্যান্ড এর উপর সাইন
Soccer players sitting on a bench	একটি বেঞ্চে বসে সকার খেলোয়াড়রা
the second hand of the clock	ঘড়ির সেকেন্ডের কাঁটা
A girl on the tennis court is preparing to hit the ball	টেনিস কোর্টের একটি মেয়ে বলটি মারার প্রস্তুতি নিচ্ছে
brick building on a city block	একটি শহর ব্লকে ইট নির্মাণ
foul lines marking the court	ফাউল লাইন দিয়ে কোর্টে দাগ টানা
A large screen with information about the players.	খেলোয়াড়দের সম্পর্কে তথ্য সহ একটি বড় পর্দা।
part of a tennis court	একটি টেনিস কোর্ট অংশ
baseball players shoe	বেসবল খেলোয়াড় জুতো
a golden stand for the tub	টব জন্য একটি সোনার স্ট্যান্ড
the trains are toy models	ট্রেনগুলি খেলনা মডেল
baseball bat in players hands	খেলোয়াড়দের হাতে বেসবল ব্যাট
person in black with a camera at the side of the court	কোর্টের পাশে ক্যামেরা সহ কালো রঙের ব্যক্তি
press type electric cooking grill	বৈদ্যুতিন রান্না গ্রিল প্রেস
Award for state fair pears	রাজ্য মেলা নাশপাতি জন্য পুরষ্কার
players shorts are red	খেলোয়াড়দের হাফপ্যান্টগুলি লাল
The sole of a second green shoe.	দ্বিতীয় সবুজ জুতা একক।
the players uniform is green and white	খেলোয়াড়দের ইউনিফর্ম সবুজ এবং সাদা
The yellow vase on the second shelf on the right.	ডানদিকে দ্বিতীয় তাকের হলুদ দানি।
a group of game officials at the corner of tennis court	টেনিস কোর্টের এক কোণে গেমের এক আধিকারিক
large patch of grass next to fast food restaurant	ফাস্ট ফুড রেস্তোরাঁয়ের পাশে ঘাসের বড় প্যাচ
Silver springs on the side of bike.	সাইকেলের পাশে সিলভার স্প্রিংস।
White copyright stamp	সাদা কপিরাইট স্ট্যাম্প
the word front on the sign in the english section	ইংরেজি বিভাগে সাইন ইন শব্দটি সামনে
Chinese characters on the window	উইন্ডোতে চীনা অক্ষর
wide brown night stand	প্রশস্ত ব্রাউন নাইট স্ট্যান্ড
cartoon characters on the bottle	বোতল উপর কার্টুন অক্ষর
top glass block in wall	দেয়ালে শীর্ষ গ্লাস ব্লক
A stand with devices on it and wires behind it.	এটিতে থাকা ডিভাইস এবং এর পিছনে তারযুক্ত একটি স্ট্যান্ড।
Several forms of public transportation	গণপরিবহন বিভিন্ন ধরণের
second skateboard in picture	ছবিতে দ্বিতীয় স্কেটবোর্ড
really fast moving hand	সত্যিই দ্রুত চলন্ত হাত
blue television on stand	স্ট্যান্ড নীল টেলিভিশন
The stand in the background with products the color white.	সাদা রঙের পণ্যগুলির সাথে পটভূমিতে স্ট্যান্ড।
A big tv on a stand	স্ট্যান্ডে একটি বড় টিভি
group of cross country skiers	ক্রস কান্ট্রি স্কিয়ার গ্রুপ
Screen of second laptop on desk	ডেস্কে দ্বিতীয় ল্যাপটপের স্ক্রিন
A time stamp	একটি সময় স্ট্যাম্প
computer monitor on stand	স্ট্যান্ডে কম্পিউটার মনিটর
white forms on a keyboard	একটি কীবোর্ডে সাদা ফর্ম
the court is made of sand	কোর্ট বালু দিয়ে তৈরি
stone block building side	পাথর ব্লক বিল্ডিং পাশ
fence around the court.	কোর্টের চারপাশে বেড়া
Blue scooter kick stand	ব্লু স্কুটার কিক স্ট্যান্ড
small patch of grass beside a tennis court	টেনিস কোর্টের পাশে ঘাসের ছোট প্যাচ
a fence between the field and players	মাঠ এবং খেলোয়াড়দের মধ্যে একটি বেড়া
Sponsor signs hanging on the walls of the tennis court.	টেনিস কোর্টের দেয়ালে ঝুলন্ত স্পনসর লক্ষণ।
Many stairs up to a second story.	অনেকগুলি সিঁড়ি দ্বিতীয় তলা পর্যন্ত।
section of fine gray sand	সূক্ষ্ম ধূসর বালির বিভাগ
Blue, yellow and white stripes on players uniform.	খেলোয়াড়দের ইউনিফর্মে নীল, হলুদ এবং সাদা ফিতে।
