en	ml
glass block privacy wall##person,person,book,handbag,book,book	ഗ്ലാസ് ബ്ലോക്ക് സ്വകാര്യ മതിൽ
knife block sitting on counter with knives in it##clock,dog,person	കത്തികൊണ്ട് കൗണ്ടറിൽ ഇരിക്കുന്ന കത്തി ബ്ലോക്ക്
a second pizza in a pan##couch,cup,chair,wine glass,oven,bowl,potted plant,chair,vase,chair	ചട്ടിയിൽ രണ്ടാമത്തെ പിസ്സ
beige stair way going to second level##person,tennis racket	ബീജ് സ്റ്റെയർ വേ രണ്ടാം ലെവലിലേക്ക് പോകുന്നു
tan house with lighter colored second floor##person,bench,vase,vase,frisbee	ടാൻ ഹൗസിലെ ഇളം നിറമുള്ള രണ്ടാം നില
Balconies on the second story of the buildings##person,motorcycle	കെട്ടിടങ്ങളുടെ രണ്ടാമത്തെ നിലയിലെ ബാൽക്കണി
Lamp on the night stand to the left of the bed##person,tennis racket,sports ball	രാത്രി സ്റ്റാന്റിലെ വിളക്ക് കട്ടിലിന്റെ ഇടതുവശത്ത് നിൽക്കുന്നു
a white alarm clock is on top of the night stand##person,person,chair,chair,chair,person,person,person,person,person	നൈറ്റ് സ്റ്റാൻഡിന് മുകളിൽ ഒരു വെളുത്ത അലാറം ക്ലോക്ക് ഉണ്ട്
a black music stand##clock	ഒരു കറുത്ത സംഗീത സ്റ്റാൻഡ്
the woman is waiting to cross the street##person,bus,person,person,truck,car	തെരുവ് മുറിച്ചുകടക്കാൻ കാത്തിരിക്കുന്ന സ്ത്രീ
these are baseball players##person,person,person,person,person,person,person,person,person,backpack	ഇവർ ബേസ്ബോൾ കളിക്കാരാണ്
Shadow on the court##bus,car,person,traffic light,person,person,person,person,person,person	കോർട്ടിലെ നിഴൽ
an alarm clock on the night stand##sheep,sports ball	രാത്രി സ്റ്റാൻഡിൽ ഒരു അലാറം ക്ലോക്ക്
The date 01/03/2008 in yellow.##person,suitcase,suitcase,suitcase,suitcase,suitcase,suitcase,suitcase,suitcase,suitcase	തീയതി 01/03/2008 മഞ്ഞയിൽ.
A brown stand next to a wall.##bed	ഒരു മതിലിനടുത്ത് ഒരു ബ്രൗണ് സ്റ്റാന്റ്
Man seated at food court table##couch,bed,person,couch,book,handbag,chair,bed,bottle,chair	ഒരാൾ ഭക്ഷണശാല മേശയുടെ സമീപം ഇരിക്കുന്നു
date stamp of scene##bowl,carrot,spoon,carrot,carrot,dining table,cake,sandwich,carrot,carrot	സീനിന്റെ തീയതി സ്റ്റാമ്പ്
Staircase leading to the second floor##person,person,tennis racket,tennis racket,tennis racket,tennis racket	രണ്ടാം നിലയിലേക്ക് നയിക്കുന്ന ഗോവണി
a camera on a stand##bus,bus,person,person,person,person,person,person,person,person	സ്റ്റാൻഡിലിരിക്കുന്ന ക്യാമറ
clear plastic French press##person,person,person,person,person,person,person,person,person,person	വ്യക്തമായ പ്ലാസ്റ്റിക് ഫ്രഞ്ച് പ്രസ്സ്
people on the second level##clock,refrigerator	രണ്ടാമത്തെ ലെവലിലെ ആളുകൾ
the court is made of sand##frisbee,dog,dog	കളിസ്ഥലം മണലിൽ നിർമ്മിച്ചതാണ്
an english saddle above a saddle pad##person,person,umbrella,person,chair,boat,dog,boat,person,kite	ഒരു സാഡിൽ പാഡിന് മുകളിലുള്ള ഒരു ഇംഗ്ലീഷ് സാഡിൽ
many utility cables cross over the street##person,person,person,person,car,car,car,car,car,person	നിരവധി ഉപയോഗപ്രദമായ കേബിളുകൾ തെരുവിലൂടെ കടന്നുപോകുന്നു
Newspaper stand on the grass##person,person,person,backpack,backpack	ന്യൂസ്‌പേപ്പർ സ്റ്റാന്റ് പുല്ലിൽ
stand in the room##clock,clock	മുറിയിലെ സ്റ്റാന്റ്
a motorcycle is parked in front of the road block##giraffe,zebra,zebra,person	റോഡ് ബ്ലോക്കിന് മുന്നിൽ ഒരു മോട്ടോർ സൈക്കിൾ പാർക്ക് ചെയ്തിരിക്കുന്നു
cross on top of church##bicycle	പള്ളിയുടെ മുകളിലെ ക്രോസ്സ്
second car parked on the street##cow,umbrella,umbrella,person,umbrella,person,person,umbrella,bench,umbrella	രണ്ടാമത്തെ കാർ തെരുവിൽ പാർക്ക് ചെയ്തു
sing is written in chinese and latin characters##cat,toilet,bottle,toilet,bottle,bottle	ചൈനീസ്, ലാറ്റിൻ അക്ഷരങ്ങളിൽ സിംഗ് എഴുതിയിട്ടുണ്ട്
A red date stamp##clock,couch,person,person,chair,dining table,person,chair,oven,couch	ഒരു ചുവന്ന തീയതി സ്റ്റാമ്പ്
Railing on second floor of building##train,person,person	കെട്ടിടത്തിന്റെ രണ്ടാം നിലയിലെ റെയിലിംഗ്
black electric clock on night stand##carrot,carrot,carrot,carrot,carrot,carrot,carrot,carrot,carrot,carrot	രാത്രി സ്റ്റാൻഡിലെ കറുത്ത ഇലക്ട്രിക് ക്ലോക്ക്
a second daybed in room##person,person,baseball glove,tennis racket,car,bench	മുറിയിലെ രണ്ടാമത്തെ ബഡ്
Paper on night stand##person,person,person,baseball glove,person,person,person,person,person,baseball glove	രാത്രി സ്റ്റാൻഡിലെ പേപ്പർ
stack of books on bed stand##tv,person,person,person,traffic light,person,person,person,person,person	ബെഡ് സ്റ്റാൻഡിൽ പുസ്തകങ്ങളുടെ ശേഖരം
the knife block is filled##person,sports ball,sports ball,sports ball,sports ball,sports ball,sports ball,sports ball,tennis racket	കത്തി ബ്ലോക്ക് നിറഞ്ഞു
plant is on a metal stand##book,clock,book,book,book,book,book,book,book,book	പ്ലാന്റ് ഒരു മെറ്റൽ സ്റ്റാൻഡിലാണ്
black metal plant stand##person,person,person,car,bench,bench,bench,handbag,handbag,bench	ബ്ലാക്ക് മെറ്റൽ പ്ലാന്റ് സ്റ്റാൻഡ്
Landline phone on the night stand##person,person	നൈറ്റ് സ്റ്റാൻഡിലെ ലാൻഡ്‌ലൈൻ ഫോൺ
wide brown night stand##person,person,cup,apple,apple,apple,apple,bottle,cup,cup	വിശാലമായ തവിട്ട് നിറത്തിലെ ചെറിയ മേശ
Bizarre sculpture on a coffee stand##person,person,person,person,baseball glove,person,person,person,car,person	ഒരു കോഫി സ്റ്റാൻഡിലെ വിചിത്രമായ ശില്പം
two people waiting to cross##person,person,chair,person,potted plant,person,person,person,person,chair	കടക്കാൻ കാത്തിരിക്കുന്ന രണ്ടുപേർ
sign on brass stand##person,snowboard,person	പിച്ചളയിൽ പൊതിഞ്ഞ സ്റ്റാൻഡ്
neon sign in a second floor window##cat	രണ്ടാം നിലയിലെ വിൻഡോയിൽ നിയോൺ ചിഹ്നം
green cross on top of building##person,sports ball,tennis racket	കെട്ടിടത്തിന് മുകളിൽ പച്ച ക്രോസ്
date palms on the grassy field##person,person,sports ball,car,person	പുല്ല് വയലിൽ ഈന്തപ്പനകൾ
Balconies on the second floor##potted plant,vase,book,book,laptop,vase,tv,book,book,book	രണ്ടാം നിലയിലെ ബാൽക്കണി
a block of buildings##sandwich,sandwich,bowl,bottle,dining table,carrot	കെട്ടിടങ്ങളുടെ ഒരു ബ്ലോക്ക്
a bunch of books on book stand##bed,vase,chair,person	ബുക്ക് സ്റ്റാൻഡിലെ ഒരു കൂട്ടം പുസ്തകങ്ങൾ
Many stairs up to a second story.##person,skateboard,bench,bench,person,person,person,bench,person,person	രണ്ടാമത്തെ സ്റ്റോറി വരെ നിരവധി പടികൾ.
second paper notice in a row##person,cow,motorcycle,truck	തുടർച്ചയായി രണ്ടാമത്തെ പേപ്പർ അറിയിപ്പ്
second floor balcony##person,tennis racket,tennis racket	രണ്ടാം നിലയിലെ ബാൽക്കണി
Bag on the cement block##person,chair,person,person,chair,person,suitcase,person,person,bench	സിമൻറ് ബ്ലോക്കിലെ ബാഗ്
the door of second floor is brown##person,person,person,person,umbrella,person,umbrella,person,person,person	രണ്ടാം നിലയുടെ വാതിൽ തവിട്ടുനിറമാണ്
Curved stairs on the approach to the court yard##clock,clock	മുറ്റത്തിനു സമീപത്ത് വളഞ്ഞ പടികൾ
the cross is black##car,car,traffic light,car,car,car,person,car,person,car	കുരിശ് കറുത്തതാണ്
grey block in sidewalk##person,person,person,person,baseball glove,sports ball,baseball glove	നടപ്പാതയിലെ ചാരനിറത്തിലുള്ള ബ്ലോക്ക്
a large block entrance##airplane,airplane,person,airplane,person,airplane,person,airplane,airplane,person	ഒരു വലിയ ബ്ലോക്ക് പ്രവേശന കവാടം
a block paved sidewalk##truck,car,truck,oven	ഒരു ബ്ലോക്ക് നടപ്പാത
people on the second floor##traffic light	രണ്ടാം നിലയിലെ ആളുകൾ
night stand made of dark brown wood##car,person,person,person,person,car,car,person,person,person	ഇരുണ്ട തവിട്ടുനിറത്തിലുള്ള മരം കൊണ്ട് നിർമ്മിച്ച രാത്രി സ്റ്റാൻഡ്
the second cushioned seat##person,person,baseball glove,person,person,baseball bat,person,person,person,person	തലയണയുള്ള രണ്ടാമത്തെ സീറ്റ്
A net in between the players##car,car,truck,car,car,car,car,car,car,car	കളിക്കാർക്കിടയിൽ ഒരു വല
a line of runway models##person,person,person,tie,potted plant,tie	റൺ‌വേ മോഡലുകളുടെ ഒരു വരി
wooden cross hanging on a wall##person,person,traffic light,umbrella,car,person,car,fire hydrant,umbrella,handbag	മരം കുരിശ് ചുമരിൽ തൂക്കിയിരിക്കുന്നു
Sandwich on the second shelf.##train	രണ്ടാമത്തെ തട്ടിൽ സാൻഡ്‌വിച്ച്.
small white rocking chair with mother and child models in it##bird,bear	അമ്മയും കുട്ടിയും മോഡലുള്ള ചെറിയ വെളുത്ത റോക്കിംഗ് കസേര, അതിൽ കളുടെ
this is a fast food place##person,airplane,person,tennis racket,backpack,cup,stop sign,person,potted plant	ഇതൊരു ഫാസ്റ്റ് ഫുഡ് സ്ഥലമാണ്
A cinder block wall.##person,tennis racket,sports ball	ഒരു സിൻഡർ ബ്ലോക്ക് മതിൽ.
red painted lines on wooden court floor##umbrella,person,person,umbrella,car,person,person,book,toothbrush,truck	മരം കോർട്ട് തറയിൽ ചുവന്ന ചായം പൂശിയ വരകൾ
the small cross on top of the headstone##bus,bus,person,person,person,car,car,person,bus,person	ഹെഡ്‌സ്റ്റോണിന് മുകളിലുള്ള ചെറിയ കുരിശ്
a manual press machine##person,person,person,dog,motorcycle,dog,person,person,person,person	ഒരു മാനുവൽ പ്രസ്സ് മെഷീൻ
People looking to cross the road.##cell phone,cell phone,cell phone,cell phone,cell phone,cell phone,cell phone,cell phone,cell phone,cell phone	റോഡ് മുറിച്ചുകടക്കാൻ നോക്കുന്ന ആളുകൾ.
A black entertainment stand on wheels##person,person	ചക്രങ്ങളിൽ ഒരു കറുത്ത വിനോദം
A big tv on a stand##laptop,laptop,laptop,person,book,book,person,person,keyboard,keyboard	ഒരു സ്റ്റാൻഡിൽ ഒരു വലിയ ടിവി
The body of the stand up lamp.##motorcycle,person,person,person,handbag,person,knife,motorcycle,clock	സ്റ്റാൻഡ് അപ്പ് വിളക്കിന്റെ ബോഡി
three windows on the second floor##person,tennis racket,potted plant,vase	രണ്ടാം നിലയിലെ മൂന്ന് വിൻഡോകൾ
The window on the right on the second floor.##person,surfboard	രണ്ടാം നിലയിലെ വലതുവശത്തുളള വിൻഡോ.
bolt on cross walk sign##train,suitcase,person,person,person,person,person,person,train,train	ക്രോസ് വാക്ക് ചിഹ്നത്തിൽ ബോൾട്ട്
tennis court floor##bed	ടെന്നീസ് കോർട്ട് ഫ്ലോർ
A girl on the tennis court is preparing to hit the ball##train,person,person,traffic light,person,chair,chair,person	ടെന്നീസ് കോർട്ടിലുള്ള ഒരു പെൺകുട്ടി പന്ത് തട്ടാൻ ഒരുങ്ങുകയാണ്
Wooden railing on second level##bird	രണ്ടാമത്തെ ലെവലിൽ മരം റെയിലിംഗ്
blue television on stand##clock,clock	സ്റ്റാൻഡിലിരിക്കുന്ന നീല ടെലിവിഷൻ
A metal and stone column holding a bell and cross.##clock,potted plant	മണിയും കുരിശും പിടിച്ചിരിക്കുന്ന ഒരു ലോഹവും കല്ലും.
White letters and numbers, indicating date and photographer.##car,traffic light,traffic light,traffic light,traffic light,stop sign,tv,traffic light	തീയതിയും ഫോട്ടോഗ്രാഫറും സൂചിപ്പിക്കുന്ന വെളുത്ത അക്ഷരങ്ങളും അക്കങ്ങളും.
Propellers too fast to see.##zebra,zebra,zebra	പ്രൊപ്പല്ലറുകൾ കാണാൻ വളരെ വേഗത്തിലാണ്.
line of trees to the left of the court##car,person,person,person,person,person,person,person,traffic light,person	കോർട്ടിന്റെ ഇടതുവശത്തുള്ള മരങ്ങളുടെ വരി
tv on a stand##person,surfboard,person,surfboard	ടിവി ഒരു സ്റ്റാൻഡിൽ
green tennis court with white lines##toilet,sink,toilet,cup,sink	വെള്ള വരകളുള്ള ഗ്രീൻ ടെന്നീസ് കോർട്ട്
street sign advising of penalty##traffic light,traffic light,traffic light,car,traffic light,car,traffic light	പെനാൽറ്റി ഉപദേശിക്കുന്ന തെരുവ് ചിഹ്നം
Several forms of public transportation##person,person,car,fire hydrant,handbag,person,handbag,umbrella,fire hydrant,person	പൊതുഗതാഗതത്തിന്റെ നിരവധി രൂപങ്ങൾ
kick stand on motorcycle##person,tennis racket,sports ball,sports ball,sports ball,sports ball,sports ball,chair,bench,bench	മോട്ടോർ സൈക്കിളിന്റെ കിക്ക് സ്റ്റാൻഡ്
the tennis court##person,cow,cow,cow,cow,cow,cow,dog	ടെന്നീസ് കോർട്ട്
fence in back of the court##person,person,person,baseball glove,baseball glove	കോർട്ടിന്റെ പുറകിലെ വേലി
Silver french press coffee maker##potted plant	സിൽവർ ഫ്രഞ്ച് പ്രസ്സ് കോഫി മേക്കർ
a railing on a second story balcony##clock,clock	രണ്ടാമത്തെ നിലയിലെ ബാൽക്കണിയിൽ ഒരു ഇരുമ്പഴി
Red T-shirt with white cross patch##bench,potted plant,potted plant,potted plant	വെളുത്ത ക്രോസ്സ് പാച്ചുള്ള ചുവന്ന ടി-ഷർട്ട്
a fine meal on a plate##train	ഒരു പാത്രത്തിൽ നല്ല ഭക്ഷണം
white characters on the street##donut,bottle,dining table,remote,chair,car,chair,sandwich	തെരുവിലെ വെളുത്ത പ്രതീകങ്ങൾ
cross next to the clock tower##couch,couch,chair,chair,chair,chair,chair,tv,chair,couch	ക്ലോക്ക് ടവറിന് അടുത്തായി കുരിശ്
person playing tennis on the court##person,backpack,book,book,book,book,book,book,book,couch	കോർട്ടിൽ ടെന്നീസ് കളിക്കുന്ന വ്യക്തി
a man in the armed forces##scissors	സായുധ സേനയിലെ ഒരാൾ
Black tv on top of brown stand.##bus,person,person,person,car,car,person,person,traffic light,person	കറുത്ത നിറത്തിലെ ടീവി ചാര നിറത്തിലുള്ള സ്റ്റാൻഡിനു മുകളിരുന്നു
a black cross on a vertical stabilizer##motorcycle,motorcycle,person,person,person,motorcycle	വെർട്ടിക്കൽ സ്റ്റെബിലൈസറിൽ ഒരു കറുത്ത ക്രോസ്
a dark blue sedan moving fast##person,person,person,baseball bat,baseball bat	ഇരുണ്ട നീല സെഡാൻ വേഗത്തിൽ നീങ്ങുന്നു
A block of brown stones.##bear	തവിട്ടുനിറത്തിലുള്ള കല്ലുകളുടെ ഒരു ബ്ലോക്ക്.
A person standing at the food stand.##sports ball,person,person,person,person,person,person,person,person,person	ഫുഡ് സ്റ്റാൻഡിൽ നിൽക്കുന്ന ഒരാൾ.
Security officer making sure everyone is safe at the fair##person,umbrella,person,umbrella,person,umbrella,person,umbrella,person,person	മേളയിൽ എല്ലാവരും സുരക്ഷിതരാണെന്ന് സുരക്ഷാ ഉദ്യോഗസ്ഥൻ ഉറപ്പാക്കുന്നു
yellow time and date stamp##person,skateboard	മഞ്ഞ സമയവും തീയതി സ്റ്റാമ്പും
boy standing on tennis court##person,person,tennis racket,car,person,person	പയ്യൻ ടെന്നീസ് കോർട്ടിൽ നിൽക്കുന്നു
"orange ""do not cross"" sign##person,tennis racket,skateboard,person,person,person,skateboard"	"ഓറഞ്ച് ""കടക്കരുത്"" ചിഹ്നം"
the players are moving##clock,clock,clock	കളിക്കാർ നീങ്ങുന്നു
Kick stand on a motorcycle.##person,person,person,person,baseball bat,baseball glove,person,person,backpack,person	ഒരു മോട്ടോർ സൈക്കിളിലെ ലിവർ
They both are playing on a tennis court.##person,person,person,frisbee	ഇരുവരും ടെന്നീസ് കോർട്ടിൽ കളിക്കുന്നു.
woman cross her arms##car,car,car,car	കൈ കെട്ടി നില്ക്കുന്ന സ്ത്രീ
The boy has a orange stamp on his hand.##person,person,bench,motorcycle,bench,potted plant,book,person,bench,book	ആൺകുട്ടിയുടെ കയ്യിൽ ഓറഞ്ച് സ്റ്റാമ്പ് ഉണ്ട്.
sign above the people at the fair##person,person,person,person,clock,person,person,banana,banana,banana	മേളയിൽ ആളുകൾക്ക് മുകളിൽ ഉള്ള ചിഹ്നം
picture hanging in the wall with anime characters##suitcase,bed	ചുമരിൽ തൂക്കിയിട്ടിരിക്കുന്ന ചിത്രത്തിൽ ആനിമേഷൻ പ്രതീകങ്ങളുണ്ട്
a net divides the court##cow,person,person,bench,person,person,person,person,person,person	ഒരു വല കോർട്ടിനെ വിഭജിക്കുന്നു
Two butcher block knive sets.##person,person,person,person,person,person,tennis racket,person,person,clock	രണ്ട് കശാപ്പ് ബ്ലോക്ക് കത്തി സെറ്റുകൾ.
cross made of stone##cow,motorcycle,person,person,person,motorcycle,person,bicycle,person,cow	കല്ലുകൊണ്ട് നിർമ്മിച്ച കുരിശ്
second story seating area##person,person,baseball bat,person,person,baseball glove,person,person,person,person	രണ്ടാമത്തെ സ്റ്റോറി സീറ്റിംഗ് ഏരിയ
english letter is white##person,frisbee,person,person,person,person,person,person,person,person	ഇംഗ്ലീഷ് അക്ഷരം വെളുത്തതാണ്
the second bus has a blue sign##couch,potted plant,vase,book,vase,chair	രണ്ടാമത്തെ ബസിന് നീല ചിഹ്നമുണ്ട്
Yellow and black pole with a yellow cross.##book,sink,book,book,book,vase,cup,book,book	മഞ്ഞ ക്രോസ്സ് ഉള്ള മഞ്ഞയും, കറുത്തയും പോൾ
the sign has asian characters##person,bowl,dining table,bowl,banana,spoon,spoon,dining table,spoon,bowl	ചിഹ്നത്തിൽ ഏഷ്യൻ പ്രതീകങ്ങളുണ്ട്
press box on tennis court##teddy bear,dog,bed	ടെന്നീസ് കോർട്ടിലെ പ്രസ്സ് ബോക്സ്
the sidewalk in front of the produce stand##person,person,person,baseball glove,baseball bat,baseball glove,cup,cup,sports ball,baseball bat	ഉൽ‌പന്നങ്ങളുടെ മുന്നിലുള്ള നടപ്പാത
The top white cross.##person,person,tennis racket,person,person,sports ball,person,chair,person,person	മുകളിൽ വെളുത്ത കുരിശ്.
a small black entertainment stand##chair,chair,chair,chair,chair,person,person,chair,person,chair	ഒരു ചെറിയ കറുത്ത വിനോദ സ്റ്റാൻഡ്
microphones are lined up on stand##toilet,toilet	മൈക്രോഫോണുകൾ സ്റ്റാൻഡിൽ അണിനിരനിരിക്കുന്നു
Woman getting ready to cross street##person,person,person,baseball glove,baseball glove	തെരുവ് മുറിച്ചുകടക്കാൻ ഒരുങ്ങുന്ന സ്ത്രീ
white lines painted on court##person,skateboard,person	കോർട്ടിൽ വരച്ച വെളുത്ത വരകൾ
A pot is fitted in a stand.##airplane,airplane,person	ഒരു സ്റ്റാൻഡിൽ ഒരു കലം ഘടിപ്പിച്ചിരിക്കുന്നു.
white graffiti on a stand##person,person,person,person,person,person,person,person,person,baseball bat	ഒരു സ്റ്റാന്റിൽ വെളുത്ത ഗ്രാഫിറ്റി
Man cross country skiing.##clock	ക്രോസ് കൺട്രി സ്കീയിംഗ് ചെയ്യുന്ന മനുഷ്യൻ
pendent on a fine chain##zebra,zebra,zebra,zebra,zebra,zebra,zebra,zebra,car,zebra	നേർത്ത ചെയിനിൽ പെൻഡന്റ്
blue tennis court##airplane	നീല ടെന്നീസ് കോർട്ട്
The right front window on the second level of the bus.##bowl,book,sink,potted plant,sink	ബസിന്റെ രണ്ടാം ലെവലിൽ വലത് മുൻവശത്തെ വിൻഡോ.
large silver juice press##vase,suitcase,suitcase,refrigerator,bowl,oven,donut,cell phone,cell phone,suitcase	വലിയ സിൽവർ ജ്യൂസ് പ്രസ്സ്
Brown block and white house with pitched black roof.##bird,bird,bird,bird,bird,bird,bird,bird,bird,bird	കറുത്ത മേൽക്കൂരയുള്ള ബ്രൗൺ ബ്ലോക്കും വൈറ്റ് ഹൗസും
man cross country skiing during race##cell phone,person,person,dining table	ഓട്ടത്തിനിടയിൽ ക്രോസ് കൺട്രി സ്കീയിംഗ് ചെയ്യുന്ന മനുഷ്യൻ
cross on top of steeple##traffic light,potted plant	സ്റ്റീപ്പിളിന് മുകളിൽ ഉള്ള ക്രോസ്സ്
second man skiing in snow##person,person,person,remote,cup,donut,couch,donut,donut,donut	രണ്ടാമത്തെ മനുഷ്യൻ മഞ്ഞിൽ സ്കീയിംഗ് ചെയ്യുന്നു
the green sign with red and yellow characters##stop sign	പച്ച ചിഹ്നത്തോടൊപ്പം ചുവപ്പ്, മഞ്ഞ പ്രതീകങ്ങൾ
a stone block train platform##cup,potted plant,sandwich,dining table,cup,bottle,vase,bottle,cat,chair	ഒരു സ്റ്റോൺ ബ്ലോക്ക് ട്രെയിൻ പ്ലാറ്റ്ഫോം
Woman wearing a cross on her neck##car,car,car,car,car,car,car	കഴുത്തിൽ കുരിശ് ധരിച്ച സ്ത്രീ
A person waiting to cross the street##skateboard,bicycle,person,bicycle,bicycle,bicycle,bicycle,bicycle,bicycle,bicycle	തെരുവ് മുറിച്ചുകടക്കാൻ കാത്തിരിക്കുന്ന ഒരാൾ
second traffic light on pole##person,horse,person	ധ്രുവത്തിലെ രണ്ടാമത്തെ ട്രാഫിക് ലൈറ്റ്
Grey cross on a green dome top.##person,person,person,person,person,person,person,sports ball,person,person	പച്ച താഴികക്കുടത്തിന്റെ മുകളിൽ ഗ്രേ ക്രോസ്സ്.
beige table lamp on stand##suitcase	ബീജ് ടേബിൾ ലാമ്പ് സ്റ്റാൻഡിൽ
armed forces identifying patch for US Army##broccoli,broccoli,broccoli,broccoli,carrot,broccoli,broccoli,broccoli,broccoli,broccoli	യുഎസ് ആർമിക്ക് പാച്ച് തിരിച്ചറിയുന്ന സായുധ സേന
Large models in the park field##bird,banana,banana,bird,bird,banana,banana,banana,banana,banana	പാർക്ക് ഫീൽഡിലെ വലിയ മോഡലുകൾ
This is some type of a fair.##refrigerator,suitcase,cup	ഇത് ഒരു തരം മേളയാണ്.
five wheels on the court##cup,book,book,book,person,clock,dining table,scissors	കോർട്ടിൽ അഞ്ച് ചക്രങ്ങൾ
a fast flowing river##banana,bicycle,banana,banana,person,banana,banana,banana,banana,banana	വേഗത്തിൽ ഒഴുകുന്ന നദി
the block of hay##umbrella,person,car,stop sign,truck,car,car,car,traffic light	പുല്ലിന്റെ ബ്ലോക്ക്
a glass block window##train	ഒരു ഗ്ലാസ് ബ്ലോക്ക് വിൻഡോ
a grill press##person,wine glass,dining table,bowl,bowl,cup,cup,bowl,cup,cup	ഒരു ഗ്രിൽ പ്രസ്സ്
block wall behind giraffe head##bed,clock,bed,remote,vase,remote,remote,remote	ജിറാഫിന്റെ തലയ്ക്ക് പിന്നിൽ തടി കൊണ്ടുള്ള മതിൽ
man stand on skateboard##vase,potted plant,apple,person	മനുഷ്യൻ സ്കേറ്റ്ബോർഡിൽ നിൽക്കുന്നു
players' names in black on yellow background##person,baseball glove,sports ball,sports ball	മഞ്ഞ പശ്ചാത്തലത്തിൽ കളിക്കാരുടെ പേരുകൾ കറുപ്പിൽ
a block defining the space for the bench##person,person,person,person,car,car,bench,handbag,airplane,car	ബെഞ്ചിനുള്ള ഇടം നിർവചിക്കുന്ന ഒരു ബ്ലോക്ക്
chairs and tables on the side of the court##motorcycle,person	കോർട്ടിന്റെ വശത്ത് കസേരകളും മേശകളും
soccer players in a light blue uniforms##cup,pizza,pizza,pizza,cup,dining table,knife,bottle,bottle,fork	ഇളം നീല നിറത്തിലുള്ള യൂണിഫോമിൽ സോക്കർ കളിക്കാർ
The word AUG in the date##person,car,traffic light,car,traffic light,traffic light	തീയതിയിലെ ഓഗ് എന്ന വാക്ക്
Top of net on tennis court##person,person,tennis racket,tennis racket	ടെന്നീസ് കോർട്ടിൽ വലയുടെ മുകൾഭാഗം
date of the recording##mouse,laptop,tv,keyboard,book,book,cup,keyboard,keyboard	റെക്കോർഡിംഗ് തീയതി
tennis court being used in a match##person,tennis racket,sports ball	ഒരു മത്സരത്തിൽ ടെന്നീസ് കോർട്ട് ഉപയോഗിക്കുന്നു
A time date stamp in the corner##sandwich,sandwich,dining table,bowl	മൂലയിൽ ഒരു സമയ തീയതി സ്റ്റാമ്പ്
The players wear uniforms.##motorcycle	കളിക്കാർ യൂണിഫോം ധരിച്ചിരിക്കുന്നു.
the fair sky##person,car,car,person,person,person,person,car,car,person	മനോഹരമായ ആകാശം
a black fine tooth comb##bus,person,bicycle,car,person,car,traffic light,car,truck,car	കറുത്ത നേർത്ത പല്ലുള്ള ചീപ്പ്
the black fast forward arrow##person,person,person,person,sports ball,sports ball,tennis racket,tennis racket,tennis racket,tennis racket	കറുത്ത ഫാസ്റ്റ് ഫോർ‌വേഡ് അമ്പടയാളം
long single block in row##person,person,sports ball,sports ball,tennis racket,tennis racket	നീളമുള്ള ഒറ്റ ബ്ലോക്ക് വരിയിൽ
two players wearing white shorts##refrigerator,hot dog,bowl,cup,spoon,cup,spoon,cup,bottle,bottle	വെളുത്ത ഷോർട്ട്സ് ധരിച്ച രണ്ട് കളിക്കാർ
fast food on white plate##traffic light,car,car,car,car,car,car,car,car,car	വൈറ്റ് പ്ലേറ്റിലെ ഫാസ്റ്റ് ഫുഡ്
Woman standing on tennis court##person,person,person,person,person,person,person,person,person,person	ടെന്നീസ് കോർട്ടിൽ നിൽക്കുന്ന സ്ത്രീ
Copy right date 2010##person,handbag,person	പകർപ്പവകാശ തീയതി 2010
letter on the wood block##person,horse,person,person,person,person,person,horse,horse,person	വുഡൻ ബ്ലോക്കിലെ അക്ഷരം
Turnstyle entrance to court##person,person,person,person,sports ball,tennis racket,sports ball,sports ball,tennis racket,sports ball	കളിസ്ഥലത്തേക്കുള്ള പ്രവേശന കവാടം
yellowish green grass over fine tan sand##motorcycle,motorcycle,person,car,motorcycle,person,car,car,person,person	നേർത്ത ടാൻ മണലിന് മുകളിൽ മഞ്ഞകലർന്ന പച്ച പുല്ല്
The date 02/10/2009.##motorcycle,person,motorcycle,person	തീയതി 02/10/2009.
the shin guard on the players leg##laptop,couch,couch,remote,tv,dining table,keyboard,book	കളിക്കാരുടെ കാലിലെ ഷിൻ ഗാർഡ്
the springs on the motorcycle##donut,person,person	മോട്ടോർ സൈക്കിളിലെ സ്പ്രിങ്ങുകൾ
signature of artist and date##person,tennis racket	ആർട്ടിസ്റ്റിന്റെ ഒപ്പും തീയതിയും
Orange color night lamp with wooden stand##laptop,tv,couch,book,book,cup,book,bowl,cup,book	തടി സ്റ്റാൻഡുള്ള ഓറഞ്ച് കളർ നൈറ്റ് ലാമ്പ്
items for sale in stand##bird,person,person,boat,boat,person,person,person,person,person	വിൽ‌പനയ്‌ക്കുള്ള ഇനങ്ങൾ‌ സ്റ്റാന്റിൽ
yellow fair pole on fence##clock,person,person,person,clock,person,person,car,person,car	വേലിയിലെ മഞ്ഞ പോൾ
the toys are on the stand##person,person,tv,person,remote,remote,book,remote,person	കളിപ്പാട്ടങ്ങൾ സ്റ്റാന്റിൽ ഇരിക്കുന്നു
small table lamp on the night stand##clock	ചെറിയ മേശയിൽ ചെറിയ മേശ വിളക്ക്
playing on green and blue court##person,person,sports ball,baseball glove,baseball glove	പച്ചയും, നീലയും ഉള്ള കോർട്ടിൽ കളിക്കുന്നു
black chinese characters n white sign##motorcycle,car,car,car,car,car,car,person,person,car	കറുത്ത ചൈനീസ് പ്രതീകങ്ങളും വെളുത്ത അടയാളവും
an english taxi cab is on the bridge##broccoli,person,spoon,knife,spoon,dining table,sandwich,broccoli,fork	ഒരു ഇംഗ്ലീഷ് ടാക്സി ക്യാബ് പാലത്തിൽ ഉണ്ട്
Landscape shrub models on display##person,book,book,tie,book,book,suitcase	ലാൻഡ്‌സ്‌കേപ്പ് കുറ്റിച്ചെടി മോഡലുകൾ പ്രദർശിപ്പിച്ചിരിക്കുന്നു
Cartoon characters on top of the building.##person,person,bed,person,dog	കെട്ടിടത്തിന്റെ മുകളിലുള്ള കാർട്ടൂൺ പ്രതീകങ്ങൾ.
date stamp on photo is 8/23/08##person,car,potted plant	ഫോട്ടോയിലെ സ്റ്റാമ്പിലെ തീയതി 8/23/08
date in the corner##person,sports ball,person,person,kite	മൂലയിൽ തീയതി
second wooden vertical slat from left##airplane,person,person	ഇടത് വശത്ത് നിന്ന് രണ്ടാമത്തെ വുഡൻ വെർട്ടിക്കൽ സ്ലാറ്റ്
colorful bus parked next to a stand and umbrella##frisbee,person,person,person,person,person,person,person,person,person	വർണ്ണാഭമായ ബസ് ഒരു സ്റ്റാൻഡിനും കുടയ്ക്കും സമീപം നിർത്തി ഇട്ടിരിക്കുന്നു
The cat is looking at the second cat.##tv,potted plant,dining table,couch,book,oven	പൂച്ച രണ്ടാമത്തെ പൂച്ചയെ നോക്കുന്നു.
There is some fine sand here##person,person,sports ball,person	കുറച്ച് നല്ല മണൽ ഇവിടെയുണ്ട്
Net across the tennis court##vase,couch,potted plant,cake	ടെന്നീസ് കോർട്ടിന് കുറുകെ ഉള്ള വല
there are english and Chinese characters##person,knife,person,orange,cup,person,cup,chair,orange,orange	ഇംഗ്ലീഷ്, ചൈനീസ് പ്രതീകങ്ങൾ ഉണ്ട്
sign laying on the second set of red apples##person,person,person,person,person,person,person	ചുവന്ന ആപ്പിളിന്റെ രണ്ടാമത്തെ സെറ്റിൽ ഇടുക
this is a press conference##chair,chair,dining table,potted plant,bottle,oven,chair,bottle,potted plant,dining table	ഇതൊരു പത്രസമ്മേളനമാണ്
woman wearing dress about to cross street##person,umbrella,person,umbrella,umbrella,umbrella,person,book,umbrella,chair	തെരുവ് മുറിച്ചുകടക്കാൻ പോകുന്ന വസ്ത്രം ധരിച്ച സ്ത്രീ
A paper towel roll on a stand##clock	ഒരു സ്റ്റാൻഡിൽ ഒരു പേപ്പർ ടവൽ റോൾ
The bolt underneath the springs.##person,person,person,chair,chair,person,tv,kite,person,dining table	സ്പ്രിങ്ങുകൾക്ക് താഴെയുള്ള ബോൾട്ട്.
two red metal springs##truck,truck	രണ്ട് ചുവന്ന ലോഹ സ്പ്രിങ്ങുകൾ
A time stamp on a video.##person,person,baseball glove,tennis racket,kite	ഒരു വീഡിയോയിൽ ഒരു ടൈം സ്റ്റാമ്പ്.
fast looking yellow motorcycle##giraffe,giraffe,giraffe,giraffe	വേഗത്തിൽ കാണപ്പെടുന്ന മഞ്ഞ മോട്ടോർസൈക്കിൾ
cross walk lines on street##person,person,person,person,person,person,person,person,person,person	തെരുവിലെ ക്രോസ്സ് വാക്ക് ലൈനുകൾ
A display of different phone models##person,person,baseball glove	വ്യത്യസ്ത ഫോൺ മോഡലുകളുടെ പ്രദർശനം
large crack in tennis court##bus,person,person	ടെന്നീസ് കോർട്ടിൽ വലിയ വിള്ളൽ
this is a concrete yellow block##person,person,person,umbrella,person,person,umbrella,person,umbrella,person	ഇതൊരു കോൺക്രീറ്റ് മഞ്ഞ ബ്ലോക്കാണ്
Picture stamped date 8/10/2013.##bicycle,bicycle,person,bottle	ചിത്രം സ്റ്റാമ്പ് ചെയ്ത തീയതി 8/10/2013.
flower on ice block##person,person,tennis racket,tennis racket,sports ball,person,person,sports ball	ഐസ് ബ്ലോക്കിലെ പുഷ്പം
some watery plant forms##person,stop sign,bicycle,car,traffic light,car,car,car,person,car	ചില ജലസസ്യങ്ങൾ
a man photographs two baseball players##kite,kite,kite,kite,kite,kite,kite,kite,kite,kite	ഒരാൾ രണ്ട് ബേസ്ബോൾ കളിക്കാരുടെ ഫോട്ടോ എടുക്കുന്നു
the date on the photo##person,oven,cup,microwave,spoon,knife,bowl,dining table,cup,cup	ഫോട്ടോയുടെ ഉള്ളിലെ തീയതി
Two toasted English muffins on a plate.##book,bird,bird,bird,bird,book	ഒരു പ്ലേറ്റിൽ രണ്ട് ടോസ്റ്റ്ട് ഇംഗ്ലീഷ് മഫിനുകൾ.
sticker is blue+white and i think written in English+kanji##person,person,umbrella,person,person,umbrella,umbrella,umbrella,umbrella,umbrella	സ്റ്റിക്കർ നീലയും വെള്ളയുമാണ്, ഇംഗ്ലീഷുംകാഞ്ചിയിലും എഴുതിയതാണെന്ന് ഞാൻ കരുതുന്നു
this license plate has non-english characters##person,person,teddy bear,teddy bear,person,person,sports ball,teddy bear	ഈ ലൈസൻസ് പ്ലേറ്റിൽ ഇംഗ്ലീഷ് അല്ലാത്ത പ്രതീകങ്ങളുണ്ട്
white block on the street##cow,person,person,person,person,person	തെരുവിലെ വൈറ്റ് ബ്ലോക്ക്
many glorious forms of opportunistic weeds##person,person,person,tennis racket,person,bottle,tennis racket,person,chair,chair	അവസരവാദ കളകളുടെ മഹത്തായ പല രൂപങ്ങൾ
Signs on signpost naming streets and block numbers##person,person,person,chair,chair,person,tennis racket,chair,chair,chair	സൈൻ‌പോസ്റ്റിൽ തെരുവ് നാമവും ബ്ലോക്ക് നമ്പറുകളിലും ഉള്ള അടയാളങ്ങൾ
Brown plastic fast food table##person,person,person,person,clock,person,person,handbag,bicycle,bicycle	തവിട്ട് പ്ലാസ്റ്റിക് ഫാസ്റ്റ് ഫുഡ് ടേബിൾ
A backwards baseball hat on the players head.##truck,bus	കളിക്കാരന്റെ തലയിൽ പിന്നിലേ ക്ക്ഒരു ബേസ്ബോൾ തൊപ്പി.
a metal orange juice press##person,person,person,person,person,person,person,backpack,person,person	ഒരു മെറ്റൽ ഓറഞ്ച് ജ്യൂസ് പ്രസ്സ്
the trains are toy models##person,tennis racket,cell phone,person,person,person,person,person,chair,person	ട്രെയിനുകൾ കളിപ്പാട്ട മോഡലുകളാണ്
the net between the two players##zebra,zebra,zebra,zebra	രണ്ട് കളിക്കാർ ക്ക് ഇടയിലുളള വല
two guys in the background are observing the movements of the players##person,person,tennis racket,bench,bench,tennis racket,bench,bench,bench	പശ്ചാത്തലത്തിലുള്ള രണ്ട് ആളുകൾ കളിക്കാരുടെ ചലനങ്ങൾ നിരീക്ഷിക്കുന്നു
yellow cross on a tie##person,skateboard,person,person,person,car,car,umbrella,cell phone,cell phone	ടൈയിലെ മഞ്ഞ ക്രോസ്
blue tennis court area##person,person,person,person,person,person,person,person,baseball bat,stop sign	നീല ടെന്നീസ് കോർട്ട് ഏരിയ
A tennis court has snow on the surface##person,tennis racket,person,sports ball,person	ഒരു ടെന്നീസ് കോർട്ടിന്റെ ഉപരിതലത്തിൽ മഞ്ഞ് ഉണ്ട്
The military plane has a cross on the tail.##cake,vase,vase,vase,vase,vase,vase,vase,vase,cake	സൈനിക വിമാനത്തിന് വാലിൽ ഒരു കുരിശുണ്ട്.
cement block facade on a building##person,vase,vase,vase,vase,vase,donut,truck	ഒരു കെട്ടിടത്തിന്റെ സിമൻറ് ബ്ലോക്ക് മുൻഭാഗം
crosswalk for pedestrians to cross##car	കാൽ‌നടയാത്രക്കാർ‌ക്ക് മുറിച്ചുകടക്കാൻ‌ ക്രോസ്സ് വാക്ക്
The time stamp is red.##motorcycle,motorcycle,motorcycle,motorcycle,motorcycle,motorcycle,motorcycle,car,motorcycle,bicycle	ടൈം സ്റ്റാമ്പ് ചുവപ്പാണ്.
an umbrella standing in a tennis court##person,person,person,person,person,baseball glove,baseball glove,person,chair,person	ഒരു ടെന്നീസ് കോർട്ടിൽ നിൽക്കുന്ന കുട
The traffic light has a red cross.##clock,clock,car,car,car,car	ട്രാഫിക് ലൈറ്റിന് ചുവന്ന ക്രോസ് ഉണ്ട്.
proprietor of the mobile lemonade stand##person,person,person,person,umbrella,umbrella,person,backpack,car,person	മൊബൈൽ നാരങ്ങാവെള്ളം വിൽക്കുന്ന ഉടമസ്ഥൻ
a clock on a glass stand##stop sign,traffic light	ഒരു ഗ്ലാസ് സ്റ്റാൻഡിൽ ഒരു ഘടികാരം
medium brown wood fine grained table##bottle,person,suitcase,suitcase,oven,person,chair	ഇടത്തരം തവിട്ട് നിറത്തിലുള്ള സുന്ദരമായ തടി മേശ
Shades of the second biker##tv,keyboard,person,book,chair	രണ്ടാമത്തെ ബൈക്കറിന്റെ ഷേഡുകൾ
baseball players sitting in dugout##clock,chair,chair,chair,chair,tv,chair,chair,bench	ഡഗഔട്ടിൽ ഇരിക്കുന്ന ബേസ്ബോൾ കളിക്കാർ
Long forks and springs##person,tie,person	നീളമുള്ള ഫോർക്കുകളും സ്പ്രിങ്ങുകളും
ink stamp in the pencil box##bird,bird,bird,bird,bird	പെൻസിൽ ബോക്സിൽ മഷി സ്റ്റാമ്പ്
An orange time stamp##person,person,skis,snowboard,backpack,skis	ഒരു ഓറഞ്ച് സമയ സ്റ്റാമ്പ്
a orange bottle in stand##bed,bed	സ്റ്റാന്റിലെ ഒരു ഓറഞ്ച് കുപ്പി
grey fine toothed comb##cat,tv	ചാരനിറത്തിൽ പല്ലുള്ള ചീപ്പ്
Front wheel on second white truck.##person,person,person,sports ball,person,person,sports ball	രണ്ടാമത്തെ വൈറ്റ് ട്രക്കിലെ മുൻ ചക്രം.
A sign in not english##keyboard,train,bowl,keyboard,chair,dining table,bottle,bus	ഒരു ചിഹ്നം ഇംഗ്ലീഷിൽ അല്ല
a fine bristled retractable brush##person,surfboard	ഉള്ളിലോട്ടു മടക്കിവെക്കാവുന്ന ബ്രഷ്
A fine white sand##person,person,person,person,person,person,baseball bat,baseball glove,baseball glove	നല്ല വെളുത്ത മണൽ
two english spaniels standing near a person##bus,person,person,person,bicycle,bicycle,person,person,person,bicycle	ഒരു വ്യക്തിയുടെ അടുത്ത് നിൽക്കുന്ന രണ്ട് ഇംഗ്ലീഷ് സ്പാനിയലുകൾ
this is a coffee press##person,baseball bat,baseball bat,person,baseball bat,baseball bat,baseball bat,baseball glove,baseball bat,bench	ഇതൊരു കോഫി പ്രസ്സാണ്
the person has fair skin##bottle,bottle,fire hydrant,oven,vase	വ്യക്തിക്ക് നല്ല ചർമ്മമുണ്ട്
a green chair on a tennis court##train,train,train	ഒരു ടെന്നീസ് കോർട്ടിൽ പച്ച കസേര
a professional tennis court##horse,horse,traffic light,person,traffic light,person,traffic light,horse,traffic light,traffic light	ഒരു പ്രൊഫഷണൽ ടെന്നീസ് കോർട്ട്
cross on a building##banana,banana,banana,banana,banana,banana,banana,banana,banana,banana	ഒരു കെട്ടിടത്തിന്റെ മുകളിലുള്ള കുരിശ്
Sis car models on top of each other##person,person,bed,person	സിസ് കാർ മോഡലുകൾ പരസ്പരം മുകളിൽ
Street sign on a pole in english and chinese##umbrella,cup,bottle,bottle,cup,bowl,bottle,bowl,potted plant	ഇംഗ്ലീഷിലും ചൈനീസിലും ഒരു ധ്രുവത്തിൽ തെരുവ് ചിഹ്നം
cross nailed to a wall##person,cow,elephant,cup,cow	ചുവരിൽ ആണി അടിച്ചുറപ്പിച്ച കുരിശ്
man in the middle of tennis court##clock,person,suitcase,suitcase,person,person,person,person,suitcase,suitcase	ടെന്നീസ് കോർട്ടിന് നടുവിലുള്ള മനുഷ്യൻ
train moving fast blurring image##person,person,sports ball,sports ball,person,person,tennis racket,tennis racket,car,tennis racket	തീവണ്ടി വേഗത്തിൽ നീങ്ങുമ്പോൾ മങ്ങുന്ന ചിത്രം
a stamp in the wood##traffic light,stop sign,scissors	വുഡിൽ ഒരു സ്റ്റാമ്പ്
black band on players wrist##person,person,person,baseball bat,baseball glove	കളിക്കാരന്റെ കൈത്തണ്ടയിൽ കറുത്ത ബാൻഡ്
the hand is going to press a button##person,person,person,person,person,sports ball	കൈ ഒരു ബട്ടൺ അമർത്താൻ പോകുന്നു
a fast moving train##person,person,backpack,skis,skis,backpack,skis,skis	വേഗത്തിൽ നീങ്ങുന്ന ട്രെയിൻ
block of cheese on plate##traffic light,car,car,person,person,traffic light,person,person,car,car	പ്ലേറ്റിൽ ചീസ് ബ്ലോക്ക്
the tv stand is blacjk incolor##stop sign	ടിവി സ്റ്റാൻഡ് ബ്ലാക്ക് കളർ ആണ്
black cap on players head##bowl,bottle,pizza,dining table,bowl,bowl,bottle,bowl,bottle,pizza	കളിക്കാരുടെ തലയിൽ കറുത്ത തൊപ്പി
cross on tower steeple##person,tv,book,book,book,book	ടവർ സ്റ്റീപ്പിൾ കുരിശ്
this is the cross##person,person,tennis racket,person,person,sports ball,bench,car,car	ഇത് ഒരു കുരിശ് ആണ്
The tennis court is two different colors.##tv,person,cup	രണ്ട് വ്യത്യസ്ത നിറങ്ങളാണ് ടെന്നീസ് കോർട്ടിന്.
red bags behind players feet##person,person,person,person,sports ball,person,sports ball,sports ball,frisbee,sports ball	കളിക്കാരുടെ പാദങ്ങൾക്ക് പിന്നിൽ ചുവന്ന ബാഗുകൾ
yellow time date stamp##clock,person,person,clock,person	മഞ്ഞ സമയ തീയതി സ്റ്റാമ്പ്
Silhouette of tennis player on court.##clock	കോർട്ടിൽ ടെന്നീസ് കളിക്കാരൻ സിലൗറ്റ്.
computer monitor on the stand##person,baseball glove,person,person,baseball glove,person,person,person,person,person	സ്റ്റാൻഡിലെ കമ്പ്യൂട്ടർ മോണിറ്റർ
a woman on the opposite team trying to block the frisbee##person,person,person,person,baseball glove,baseball bat,person,person,person,person	എതിർ ടീമിലെ ഒരു സ്ത്രീ ഫ്രിസ്‌ബിയെ തടയാൻ ശ്രമിക്കുന്നു
The line on the tennis court is white.##cat,cat	ടെന്നീസ് കോർട്ടിലെ ലൈൻ വെളുത്തതാണ്.
cone of plane appears dark, shiny and fast##person,umbrella,person,car,car,person,person,umbrella,umbrella,umbrella	വിമാനത്തിന്റെ കോൺ ഇരുണ്ടതും തിളക്കമുള്ളതും വേഗതയുള്ളതുമായി കാണുന്നു
blue cross on front of car##person,person,tennis racket,tennis racket,tennis racket,stop sign	കാറിന് മുന്നിൽ നീല കുരിശ്
a metal cross beam##clock,sink,vase,person	ഒരു മെറ്റൽ ക്രോസ്സ് ബീം
a young girl with a fair complexion##	നല്ല നിറമുള്ള ഒരു പെൺകുട്ടി
the line that shows foul or fair##traffic light,person,traffic light,car,bus,car	മോശം അല്ലെങ്കിൽ ന്യായമായത് കാണിക്കുന്ന വരി
White striped pedestrian cross-walk painted on street.##cat,bicycle,person,chair,person,bicycle	തെരുവിൽ വരച്ച വെളുത്ത വരയുള്ള നടപ്പാത
A stand mixer##truck,bus,car,truck,car,car,truck,person,bus,car	ഒരു സ്റ്റാൻഡ് മിക്സർ
the balcony on the second floor##person,person,person,person,person,person,person,person,person,train	രണ്ടാം നിലയിലെ ബാൽക്കണി
leg of the second person##stop sign,boat,car,boat,boat,car,person	രണ്ടാമത്തെ വ്യക്തിയുടെ കാല്
person doing a hand stand##person,person,person,person,person,person,bottle,person,tie,person	ഹാൻഡ് സ്റ്റാൻഡ് ചെയ്യുന്ന വ്യക്തി
A train is going very fast##car,person,car,car,car,car,truck,motorcycle,person	ട്രെയിൻ വളരെ വേഗത്തിൽ പോകുന്നു
child forces straws into a a can##clock,car,car,traffic light	കുട്ടി സ്ട്രോ കാനിലേക്ക് തള്ളി വെക്കുന്നു
blue box on tennis court##laptop,mouse,book,book,dining table,bowl,keyboard,book,book,scissors	ടെന്നീസ് കോർട്ടിലെ നീല ബോക്സ്
a red tennis shoe on players foot##person,tennis racket	കളിക്കാരുടെ കാലിൽ ചുവന്ന ടെന്നീസ് ഷൂ
an apple cider press##dog,parking meter,apple,apple,apple,apple,apple	ഒരു ആപ്പിൾ ജ്യൂസ്‌ എടുക്കുന്ന യന്ത്രം
black Samsung tv on the tv stand##person,person,person,person,person,kite,kite,person,person,person	ടിവി സ്റ്റാൻഡിലെ കറുത്ത സാംസങ് ടിവി
the models are red and black##banana,chair,clock,dining table,couch	മോഡലുകൾ ചുവപ്പും കറുപ്പും ആണ്
chainlink fencing forms a field exit##person,person,person,bicycle,bicycle,car,person,bicycle,bicycle,person	ചെയിൻലിങ്ക് ഫെൻസിംഗ് ഒരു ഫീൽഡ് എക്സിറ്റ് ഉണ്ടാക്കുന്നു
Red tie with Peanuts characters##cake,dining table,wine glass	പീനട്ട് പ്രതീകങ്ങളുള്ള ചുവന്ന ടൈ
white springs under bed##person,person,person,person,person,person,person,person,person,person	കട്ടിലിനടിയിലെ വെള്ള സ്രോതസ്സ്
a metal stand under the seat of a bench##person,microwave	ഒരു ബെഞ്ചിന്റെ സീറ്റിനടിയിൽ മെറ്റൽ സ്റ്റാൻഡ് ഉണ്ട്
this wall forms a stall##person,person,person,person,person,person,person,person,person,banana	ഈ മതിൽ ഒരു സ്റ്റാളായി മാറുന്നു
green grass behind players##person,tennis racket,person,person,person	കളിക്കാർക്ക് പിന്നിൽ പച്ച പുല്ല്
Grate over a concrete block##clock,person,person,person,person,person,person	ഒരു കോൺക്രീറ്റ് ബ്ലോക്കിന് മുകളിൽ ഗ്രേറ്റ്
the Asian characters are red##clock	ഏഷ്യൻ പ്രതീകങ്ങൾ ചുവപ്പാണ്
an english muffin sandwich##person,person,dog,frisbee,potted plant,clock	ഒരു ഇംഗ്ലീഷ് മഫിൻ സാൻഡ്‌വിച്ച്
players in dirt circle##person,tennis racket	അഴുക്ക് സർക്കിളിലെ കളിക്കാർ
the wall is cement block##bench,bench,bench,person,bench,bench,bench,chair,bench,chair	മതിൽ സിമന്റ് ബ്ലോക്കാണ്
a layer of fine sweet chocolate##tv,person,book,book,book,book,book,book,book,book	മനോഹരമായ മധുരമുള്ള ചോക്ലേറ്റ് പാളി
rapid in fast water##person	വേഗത്തിലുള്ള വെള്ളം ദ്രുതഗതിയിൽ
date when taken in yellow##cup,dining table,chair,sandwich,sandwich,dining table,cup	മഞ്ഞനിറത്തിൽ എടുത്ത തീയതി
block of snow on a hill##tv,bed,chair,potted plant,dining table,chair,bed,oven,dining table,dining table	ഒരു കുന്നിലെ മഞ്ഞിന്റെ ബ്ലോക്ക്
The time stamp display window on the meter on the left.##tv,chair,bottle,chair,bed,chair,chair,bottle,chair,bottle	ഇടതുവശത്തുള്ള മീറ്ററിലെ ടൈം സ്റ്റാമ്പ് ഡിസ്പ്ലേ വിൻഡോ.
blue net around tennis court##bicycle,traffic light,traffic light,traffic light,traffic light,traffic light,traffic light,traffic light,car,traffic light	ടെന്നീസ് കോർട്ടിന് ചുറ്റും നീല വല
fast train moving along track##person,surfboard	വേഗത്തിലുള്ള ട്രെയിൻ ട്രാക്കിലൂടെ നീങ്ങുന്നു
box springs under a bed##person,bottle,bowl,sink,knife,knife,bottle,spoon,cup,bottle	ഒരു കട്ടിലിനടിയിൽ സ്പ്രിങ്ങുകൾ
Large tv on black stand.##kite,kite,kite,kite,person,kite,person,person,person,person	കറുത്ത സ്റ്റാൻഡിൽ വലിയ ടിവി.
date stamp in the corner##apple,apple,apple,person,apple,apple,apple,apple,apple,apple	മൂലയിലെ തീയതി സ്റ്റാമ്പ്
fading on the court##person,person,person,person,person,handbag,orange,person,person,orange	കോർട്ടിലെ മങ്ങൽ
concrete or cinder block walls##tv,remote,remote,person,person,person,book,keyboard,book,person	കോൺക്രീറ്റ് അല്ലെങ്കിൽ സിൻഡർ ബ്ലോക്ക് മതിലുകൾ
person in black with a camera at the side of the court##laptop,bottle,cell phone,bottle,mouse,book,cell phone,book,book,book	കളിസ്ഥലത്തിന്റെ ഒരു വശത്ത് ക്യാമറയുള്ള കറുത്ത വ്യക്തി
Some traffic is moving very fast##laptop,person,person,laptop,potted plant,person,vase,chair,cup,couch	ചില ട്രാഫിക് വളരെ വേഗത്തിൽ നീങ്ങുന്നു
Two men on a tennis court playing tennis##person,tie,book,tie	ടെന്നീസ് കോർട്ടിൽ രണ്ടുപേർ ടെന്നീസ് കളിക്കുന്നു
poles that block entrance by large vehicles##bus,traffic light,traffic light,bus,bus,person,person,person,person,car	വലിയ വാഹനങ്ങളുടെ പ്രവേശനം തടയുന്ന പോളുകൾ
The stand in the background with products the color white.##person,person,person,person,banana,banana,person,person,banana,banana	ഉൽപ്പന്നങ്ങളുടെ വർണ്ണത്തിന്റെ പശ്ചാത്തലത്തിലുള്ള സ്റ്റാൻഡ്
unfinished wood block under freezer##person,sports ball,person,person,sports ball,sports ball,person,sports ball,person,person	ഫ്രീസറിനു കീഴിലുള്ള പൂർത്തിയാകാത്ത മരം ബ്ലോക്ക്
a date stamp for 2010/02/07##person,tennis racket	2010/02/07 ലെ തീയതി സ്റ്റാമ്പ്
the banana hanging from the stand##motorcycle,person,person	വാഴപ്പഴം സ്റ്റാൻഡിൽ തൂക്കിയിരിക്കുന്നു
People on the court playing tennis.##person,baseball bat,sports ball,backpack,chair	കോർട്ടിൽ ആളുകൾ ടെന്നീസ് കളിക്കുന്നു.
three baseball players standing in a row##person,tie,person,person,person,person,tie,person,person,person	മൂന്ന് ബേസ്ബോൾ കളിക്കാർ വരിയിൽ നിൽക്കുന്നു
the date stamp in the corner of the pic##car,car,car,truck,truck,car,car,traffic light,traffic light,truck	ചിത്രത്തിന്റെ കോണിലുള്ള തീയതി സ്റ്റാമ്പ്
the fence covered in netting at the end of the court##motorcycle,person,car	കോർട്ടിന്റെ അവസാനം വലയിൽ പൊതിഞ്ഞ വേലി
a very fast baseball##person,person,person,sports ball,person,person,car	വളരെ വേഗതയുള്ള ബേസ്ബോൾ
big hairy fair laps##bottle,wine glass,person,bottle,person,dining table,person	വലിയ രോമമുള്ള ഫെയർ ലാപ്‌സ്
Knives in a wooden block on the countertop.##person,tennis racket,person,chair,person,person,person,person,person,person	കൗണ്ടർ‌ടോപ്പിലെ ഒരു വുഡൻ ബ്ലോക്കിലെ കത്തികൾ.
an off white set of box springs##truck,truck,person,truck,truck,truck,truck,person,truck,person	വെളുത്ത നിറത്തിലുള്ള ബോക്സ്
a knife block on the shelf##toilet,skateboard	അലമാരയിലെ ഒരു കത്തി ബ്ലോക്ക്
a business man waiting to cross the street##cat,couch	തെരുവ് മുറിച്ചുകടക്കാൻ കാത്തിരിക്കുന്ന ഒരു ബിസ്സിനസ്സുകാരൻ
blue plastic hot dog stand##person,person,person,tennis racket,person,person,person,person,person,person	നീല പ്ലാസ്റ്റിക് ഹോട്ട് ഡോഗ് സ്റ്റാൻഡ്
large green and purple tennis court##surfboard,surfboard,surfboard,surfboard,surfboard,surfboard,skateboard,skateboard	വലിയ പച്ചയും, പർപ്പിളും ഉള്ള ടെന്നീസ് കോർട്ട്
ink stamp print##donut,donut,donut,donut,donut,donut,person,donut,donut	മഷി സ്റ്റാമ്പ് പ്രിന്റ്
chain-linked fence behind players##traffic light,clock	കളിക്കാർക്ക് പിന്നിൽ ചങ്ങല വേലി
A clock with cartoon characters on##clock,horse,horse	കാർട്ടൂൺ പ്രതീകങ്ങളുള്ള ഒരു ക്ലോക്ക്
Dirt is on the baseball players outfit##horse,bear	ബേസ്ബോൾ കളിക്കാരുടെ വസ്ത്രത്തിലാണ് അഴുക്ക്
grey characters on a sign##person,tennis racket	ഒരു ചിഹ്നത്തിലെ ചാരനിറത്തിലുള്ള പ്രതീകങ്ങൾ
players are playing baseball.##airplane,person,airplane	കളിക്കാർ ബേസ്ബോൾ കളിക്കുന്നു.
block for bench feet##person,person,person,person,cell phone,cup	ബെഞ്ച് ഫീറ്റിനായുള്ള ബ്ലോക്കുകൾ
cross structures for bridge support##airplane	ബ്രിഡ്ജ് പിന്തുണയ്ക്കുള്ള ക്രോസ്സ് സ്ട്രക്ചറുകൾ
A small wave forms on the water.##horse,horse,banana,cow,bird,horse	ഒരു ചെറിയ തരംഗം വെള്ളത്തിൽ രൂപം കൊള്ളുന്നു.
white forms on a keyboard##pizza,knife,pizza,pizza,pizza,pizza,person,pizza,pizza,pizza	ഒരു കീബോർഡിൽ വെളുത്ത ഫോമുകൾ
knife on the chopping block##cup,cup,chair,umbrella,chair,dining table,umbrella,spoon,chair,spoon	ചോപ്പിംഗ് ബ്ലോക്കിലെ കത്തി
Black block with number on it##giraffe	നമ്പറുള്ള കറുത്ത ബ്ലോക്ക്
Two press buttons of the sweater##person,tennis racket,person,bicycle	സ്വെറ്ററിന്റെ രണ്ട് പ്രസ്സ് ബട്ടണുകൾ
Screen of second laptop on desk##person,dining table,tie,bottle,book,sports ball	ഡെസ്‌കിലെ രണ്ടാമത്തെ ലാപ്‌ടോപ്പിന്റെ സ്‌ക്രീൻ
date in red letters and numerals##person,person,person,person,tennis racket,tennis racket,tennis racket,tennis racket,car,car	ചുവന്ന അക്ഷരങ്ങളിലും അക്കങ്ങളിലും ഉള്ള തീയതി
a block, yellow, and white baseball uniform##tv,cup,potted plant,vase,person,skateboard,book,bowl,vase,book	ഒരു ബ്ലോക്ക്, മഞ്ഞ, വെള്ള ബേസ്ബോൾ യൂണിഫോം
A tin container decorated with Star Wars characters and themes##chair,cup,tv,book,mouse,dining table,book,dining table,dining table,dining table	സ്റ്റാർ വാർസ് പ്രതീകങ്ങളും തീമുകളും കൊണ്ട് അലങ്കരിച്ച ഒരു ടിൻ കണ്ടെയ്നർ
characters are posted in Chinese##person,person,tennis racket,tennis racket	പ്രതീകങ്ങൾ ചൈനീസ് ഭാഷയിൽ പോസ്റ്റുചെയ്‌തു
woman in back of a court##clock,clock	ഒരു കോർട്ടിന്റെ പിന്നിലുള്ള സ്ത്രീ
a romantic date night##person,person,person,person,person,person,sports ball,person,person,person	ഒരു റൊമാന്റിക് ഡേറ്റ് രാത്രി
A skier going down fast on a slope##car,car,motorcycle	ഒരു ചരി വിൽ വേഗത്തിൽ താഴേക്ക് പോകുന്ന ഒരു സ്കയർ
Two tennis players standing together##bed,chair,book,dining table,laptop,book	രണ്ട് ടെന്നീസ് കളിക്കാർ ഒരുമിച്ച് നിൽക്കുന്നു
One person on the court##	കളിസ്ഥലത്തു ഒരാൾ
Brown tennis court with white lines.##cup,cup,cup,cup,bowl,dining table,chair,cup,cup,cup	വെളുത്ത വരകളുള്ള ബ്രൗണ് ടെന്നീസ് കോർട്ട്.
two players in orange and white sitting on sidelines##person,person,chair,tennis racket,person,sports ball,person,chair,cup,bench	ഓറഞ്ച്, വൈറ്റ് നിറങ്ങളിലുള്ള രണ്ട് കളിക്കാർ വശങ്ങളിലായി ഇരിക്കുന്നു
A person below the date##person,person,cake,person,cake,dining table,cake,chair,person	തീയതിക്ക് താഴെയുള്ള ഒരു വ്യക്തി
english muffin with egg and hollandaise##banana,sandwich,dining table	മുട്ടയും ഹോളണ്ടൈസും ഉള്ള ഇംഗ്ലീഷ് മഫിൻ
silver and black French press coffee pot##person,person,person,person,chair,tennis racket,tennis racket,chair,person,person	വെള്ളിയും, കറുപ്പും ഫ്രഞ്ച് പ്രസ്സ് കോഫി പോട്ട്
a motorcycle side stand##person,car,cell phone,bus,truck,car	ഒരു മോട്ടോർസൈക്കിൾ സൈഡ് സ്റ്റാൻഡ്
wood cross##chair,chair,chair,book,bench,book,book,book,book,book	മരം കുരിശ്
a blue and white cross walk sign##person,person,tv,person,person,person,person,cell phone,person	നീലയും വെള്ളയും ക്രോസ് വാക്ക് ചിഹ്നം
section of fine gray sand##person,tennis racket,person	ചാരനിറത്തിലുള്ള മണലിന്റെ ഭാഗം
a wooden block of knives##person,person,person,chair,tennis racket,tennis racket,person,sports ball,tennis racket	കത്തികളുടെ തടി
fast food chicken patty##vase,bed,bed,couch,couch,cell phone,cell phone,bowl	ഫാസ്റ്റ് ഫുഡ് ചിക്കൻ പാറ്റി
A motorcyclist driving very fast##person,skateboard,person,person,person,person,train,person,person	ഒരു മോട്ടോർ സൈക്കിൾ യാത്രക്കാരൻ വളരെ വേഗത്തിൽ ഓടിക്കുന്നു
stone block building side##stop sign,car,car,car,car,car,car,car,truck	കല്ല് കൊണ്ട് നിർമിതമായ കെട്ടിടം
Number of court on the wall.##	ചുമരിലെ കോർട്ടിന്റെ എണ്ണം.
logo stamp on the door##person,refrigerator,bottle,bottle,banana	വാതിലിലെ ലോഗോ സ്റ്റാമ്പ്
tennis court in bounds area for doubles play##person,person,tennis racket,sports ball,sports ball,tennis racket	ടെന്നീസ് കോർട്ടിലെ ഡബിൾസ് കളിക്കാനായിട്ടുള്ള ബൌഡറി ഏരിയ
fine white spray against nose of craft##person,umbrella,person,person,boat,umbrella,person,person	കരകൗശലത്തിന്റെ മൂക്കിന് നേരെ വെളുത്ത സ്പ്രേ
box springs with flower print##horse,horse,horse	പുഷ്പ പ്രിന്റുള്ള ബോക്സ് സ്പ്രിങ്ങുകൾ
White boundary lines on the tennis court.##person,skis	ടെന്നീസ് കോർട്ടിൽ വെളുത്ത അതിർത്തി ലൈനുകൾ.
block behind the woman##person,person,person,person,tennis racket,tennis racket,bottle,sports ball,person,sports ball	സ്ത്രീയുടെ പിന്നിൽ ബ്ലോക്ക്
A grey rock wall forms a boundary of the enclosure##person,person,person,person,car,car,umbrella,person,umbrella,traffic light	ചാരനിറത്തിലുള്ള ഒരു പാറ മതിൽ ചുറ്റുമതിലിന്റെ അതിർത്തിയായി മാറുന്നു
the sign has white characters##oven,refrigerator,microwave,cup,spoon,spoon	ചിഹ്നത്തിൽ വെളുത്ത പ്രതീകങ്ങളുണ്ട്
a white line a cross the field##person,person,truck,person,car,motorcycle,truck,truck,chair	ഫീൽഡിനു കുറുകെ ഒരു വെളുത്ത വര
the judge's chair by the court##person,person,person,person,baseball bat,person,person,person,chair,person	കളിസ്ഥലത്തു വിധികർത്താവിന്റെ കസേര
An electronic display showing the date##tv,suitcase	തീയതി കാണിക്കുന്ന ഒരു ഇലക്ട്രോണിക് ഡിസ്പ്ലേ
window planters outside second story##bus,dining table,dining table,chair,chair,chair,chair,chair,person,dining table	രണ്ടാമത്തെ നിലക്ക് പുറത്തുള്ള ജനാല ഉദ്യാനം
Windows logo stamp on laptop.##person,person,person,person,person,person,person,skis,skis,skis	ലാപ്‌ടോപ്പിൽ വിൻഡോസ് ലോഗോ സ്റ്റാമ്പ്.
The characters 9F on the side of a plane##person,tennis racket	ഒരു വിമാനത്തിന്റെ വശത്തുള്ള 9 എഫ് പ്രതീകങ്ങൾ
A second sandwich on a wrapper.##person,person,person,baseball bat,person,person,baseball glove,person,sports ball,person	ഒരു റാപ്പറിൽ രണ്ടാമത്തെ സാൻഡ്‌വിച്ച്.
tennis court marked with white color##car,donut,person,person,person,cake,car,person,person,person	വെളുത്ത നിറത്തിൽ അടയാളപ്പെടുത്തിയ ടെന്നീസ് കോർട്ട്
women waiting to cross##laptop,tv,keyboard,mouse,chair,keyboard,spoon,person	കടക്കാൻ കാത്തിരിക്കുന്ന സ്ത്രീകൾ
fast food in the backgrond##person,person,bottle,person,person,person,person,person,person,person	ബാക്ക്ഗ്രൗണ്ടിലെ ഫാസ്റ്റ് ഫുഡ്
foreign characters on the vehicle's side##motorcycle,person,handbag,person,person,person,person,handbag,truck,person	വാഹനത്തിന്റെ വശത്തുള്ള വിദേശ പ്രതീകങ്ങൾ
Blue garbage can on second floor.##teddy bear,skis,kite	രണ്ടാം നിലയിൽ നീല ചവറ്റുകുട്ട.
large patch of grass next to fast food restaurant##person,boat,boat,boat,boat,potted plant,person,boat,boat,boat	ഫാസ്റ്റ്ഫുഡ് റെസ്റ്റോറന്റിന് അടുത്തുള്ള വലിയ പറമ്പ്
white Asian language characters painted on middle of street##person,person,person,person,person,person,person,bus,umbrella,motorcycle	തെരുവിന്റെ മധ്യത്തിൽ വരച്ച വെളുത്ത ഏഷ്യൻ ഭാഷാ പ്രതീകങ്ങൾ
brown wooden stairs leading to second floor##person,bench,car,car,tennis racket,bench,sports ball,person,traffic light	രണ്ടാം നിലയിലേക്ക് നയിക്കുന്ന തവിട്ട് തടി പടികൾ
a green part of a tennis court.##person,tennis racket,sports ball,person	ടെന്നീസ് കോർട്ടിന്റെ ഒരു പച്ച ഭാഗം.
A man stand next to a jeep.##motorcycle,car,motorcycle,car,person,motorcycle,motorcycle,car,motorcycle,person	ഒരാൾ ജീപ്പിന്റെ അരികിൽ നിൽക്കുന്നു.
ginger with fair skin, orange hair, billions of freckles, and glasses##clock	ചുണയുള്ള വെളുത്ത നിറം, ഓറഞ്ച് മുടി, നിറയെ കാക്കപ്പുള്ളികലും കണ്ണാടിയും
black metal cross-walk light##person,sports ball,person,bench,person,bench	കറുത്ത മെറ്റൽ ക്രോസ്സ്-വാക്ക് ലൈറ്റ്
Oranges on a fruit stand##cell phone,mouse,person,person	ഫ്രൂട്ട് സ്റ്റാൻഡിലെ ഓറഞ്ച്
a man in front of a produce stand##person,sports ball,baseball bat,bench	ഒരു മനുഷ്യൻ കടയുടെ മുന്നിൽ നിൽക്കുന്നു
a green Christmas tree stand##toilet,boat	ഒരു പച്ച ക്രിസ്മസ് ട്രീ സ്റ്റാൻഡ്
books in a black stand##clock,traffic light,traffic light,car,traffic light,potted plant,car,traffic light,traffic light,traffic light	കറുത്ത സ്റ്റാന്റിലെ പുസ്തകങ്ങൾ
Red and white Stop sign with characters in a non-English language##person,person,tennis racket,tennis racket,bench,person,person	ഇംഗ്ലീഷ് ഇതര ഭാഷയിൽ ചുവപ്പും വെള്ളയും നിർത്തുക പ്രതീകങ്ങളുള്ള അടയാളം
a block lower half of a wall##person,motorcycle,car	ഒരു മതിലിന്റെ താഴത്തെ പകുതി
date and time of picture##horse,horse,horse,horse,horse,person,horse,person,horse,person	ചിത്രത്തിന്റെ തീയതിയും സമയവും
power lines cross in the air##person,person,person,person,person,tennis racket,tennis racket,person,tennis racket,tennis racket	വൈദ്യുതി ലൈനുകൾ വായുവിൽ കടന്നുപോകുന്നു
The items on the top shelf have painted characters on them##person,tennis racket,sports ball,potted plant,chair,chair,person	മുകളിലെ ഷെൽഫിലെ ഇനങ്ങളിൾ പ്രതീകങ്ങൾ വരച്ചിട്ടുണ്ട്
microphone on the court##truck,car,car,person	കോർട്ടിൽ മൈക്രോഫോൺ
second man looking over first's shoulder##person,tennis racket,tennis racket	ആദ്യ മനുഷ്യന്റെ തോളിൽ നോക്കുന്ന രണ്ടാമത്തെ മനുഷ്യൻ
thumb press into a doughnut##person,bus,person,person,person,person,person,person,person,person	ഒരു ഡോണറ്റിലേക്ക് തള്ളവിരൽ അമർത്തിയത്
name and date in the corner##train,train,person,bus,person,boat	മൂലയിലുള്ള പേരും തീയതിയും
a colorful display lighted characters##bear	വർണ്ണാഭമായ ഡിസ്‌പ്ലേ ലൈറ്റ് ചെയ്ത പ്രതീകങ്ങൾ
a block wall behind the man##person,person,person,person,person,person,tie,tie,person,person	മനുഷ്യന്റെ പുറകിൽ ഒരു മതിൽ
The speaker on the stand##person,tennis racket,person,person,tennis racket	സ്‌പീക്കർ സ്റ്റാൻഡിൽ നിൽക്കുന്നു
the time stamp sitting in the corner##person,person,person,cup,bottle,cell phone,bottle,dining table,cup,baseball bat	മൂലയിൽ ഇരിക്കുന്ന ടൈം സ്റ്റാമ്പ്
guy's hand trying to block the camera##traffic light,traffic light,traffic light,traffic light,traffic light,traffic light,traffic light,traffic light,traffic light,traffic light	ക്യാമറ തടയാൻ ശ്രമിക്കുന്ന ആളുടെ കൈ
a cross sign on top of the tower##person,person,skis	ഗോപുരത്തിന് മുകളിൽ ഒരു ക്രോസ് ചിഹ്നം
train going by fast##person,tennis racket,sports ball	വേഗത്തിൽ പോകുന്ന ട്രെയിൻ
The white ice models in the room.##person,person,skis,skis	മുറിയിലെ വെളുത്ത ഐസ് മോഡലുകൾ.
black remote on the tv stand##sink,toilet	ടിവി സ്റ്റാൻഡിലെ കറുത്ത റിമോട്ട്
second hand on clock##clock	ക്ലോക്കിലെ മിനിറ്റ് സൂചി
a red sign advertising a fun fair##person,cup,vase,chair,cup,dining table,cup,bowl,cake,cup	രസകരമായ മേള പരസ്യം ചെയ്യുന്ന ചുവന്ന ചിഹ്നം
top glass block in wall##person,person,tie,person,car,car,tie,person,person,car	മതിലിലെ ടോപ്പ് ഗ്ലാസ് ബ്ലോക്ക്
green baseball field with players on it##airplane,airplane,airplane,airplane	പച്ച ബേസ്ബോൾ ഫീൽഡിൽ കളിക്കാർ
A large pipe extending from the wall of the court.##person,person,stop sign,bicycle,potted plant,potted plant,bench,parking meter	കോർട്ടിന്റെ മതിലിൽ നിന്ന് നീളുന്ന ഒരു വലിയ പൈപ്പ്.
a fine skateboard##person,person,person,person,chair,person,person,chair,person,person	ഒരു ഫൈൻ സ്കേറ്റ്ബോർഡ്
french press coffee maker on the table##person,person,kite,kite,kite	ഫ്രഞ്ച് പ്രസ്സ് കോഫി നിർമാതാവ് മേശപ്പുറത്ത്
fast moving ball towards home plate##person,tennis racket	ഹോം പ്ലേറ്റിലേക്ക് വേഗത്തിൽ നീങ്ങുന്ന പന്ത്
A stand with devices on it and wires behind it.##person,person,person,person,person,skis,person,skis,skis,kite	അതിൽ ഉപകരണങ്ങളും പിന്നിൽ വയറുകളുമുള്ള ഒരു തട്ട്
a a block in a wall##person,skateboard,person,person,person,person,person,person,person,person	ആ ഒരു ബ്ലോക്ക് ഉള്ള മതിൽ
fine china plate with gold rim##cat,fork	സ്വർണ്ണ വരയുള്ള ചൈന പ്ലേറ്റ്
the combs are fine##person,tennis racket,person,sports ball,sports ball,sports ball,sports ball,sports ball,sports ball	നല്ല ചീപ്പുകൾ
two players watching the batter##person,person,person,person,person,umbrella,person,person,person,person	രണ്ട് കളിക്കാർ ബാറ്റർ കാണുന്നു
Yellow criss cross on the street by train.##banana	ട്രെയിനിൽ നിന്ന് തെരുവിലേക്ക് മഞ്ഞ ക്രിസ്സ് ക്രോസ്.
time and date stamp on the photograph##person,wine glass,person,person,wine glass,wine glass,person,wine glass,wine glass,bottle	ഫോട്ടോയിലെ സമയവും തീയതിയും സ്റ്റാമ്പ്
black iron gate with white cross##person,person,person,baseball bat,baseball bat,cell phone,cell phone,person	വെളുത്ത കുരിശുള്ള കറുത്ത ഇരുമ്പ് ഗേറ്റ്
the white cross on the flag##traffic light,traffic light,truck,truck,car,car,car,car,car,car	പതാകയിലെ വെളുത്ത കുരിശ്
a pole of a lamp stand##airplane	വിളക്ക് സ്റ്റാന്റിന്റെ ഒരു പോൾ
neutral makeup on both rain models##bus	രണ്ട് മോഡലുകളിലും ന്യൂട്രൽ മേക്കപ്പ്
large green bench press on the table##clock,potted plant	വലിയ പച്ച ബെഞ്ച് പ്രസ്സ് മേശപ്പുറത്ത്
a red cross on the paper##fork,bottle,cup,cup,knife,dining table,hot dog,fork,cake,pizza	കടലാസിലെ ഒരു ചുവന്ന കുരിശ്
cartoon characters on the bottle##oven,laptop,bottle,refrigerator,cup,bottle	കുപ്പിയിലെ കാർട്ടൂൺ പ്രതീകങ്ങൾ
ridged metal pole stand to a large clock##person,person,person,person,person,sports ball,baseball bat,baseball bat,chair,chair	വരമ്പുകൾ ഉള്ള മെറ്റൽ പോൾ ഒരു വലിയ ക്ലോക്കിലേക്ക് നിൽക്കുന്നു
the second hand on the clock##person,person,sports ball,person,person,person,tennis racket	ക്ലോക്കിന്റെ രണ്ടാമത്തെ കൈ
red ground of a tennis court##person,person,person,skis,person,person,person,skis,person,car	ഒരു ടെന്നീസ് കോർട്ടിന്റെ ചുവന്ന നിലം
the players lean on the fence##person,person,person,person,sports ball,baseball glove,person,person,baseball glove,baseball glove	കളിക്കാർ വേലിയിൽ ചാഞ്ഞു നില്ക്കുന്നു
A small grey block on the median##train,person,train,traffic light,traffic light,traffic light,traffic light,train,train,train	മീഡിയനിലെ ഒരു ചെറിയ ചാരനിറത്തിലുള്ള ബ്ലോക്ക്
pole behind second baseman##toilet,sink,hair drier,cup	രണ്ടാമത്തെ ബേസ്മാന്റെ പിന്നിലുള്ള പോൾ
a plate with white characters##oven,person,person,knife	വെളുത്ത പ്രതീകങ്ങളുള്ള ഒരു പ്ലേറ്റ്
cross section of a broccoli stem##person,tennis racket	ഒരു ബ്രൊക്കോളി തണ്ടിന്റെ ക്രോസ്സ് സെക്ഷൻ
large date palm in the distance##boat,person,person,person,person,person	ദൂരത്തുള്ള വലിയ ഈന്തപ്പന
Three baseball players at first base##car	ആദ്യ അടിത്തട്ടിൽ മൂന്ന് ബേസ്ബോൾ കളിക്കാർ
hairy arm with fair pale skin##person,hot dog,hot dog,cup,donut,dining table,donut,bowl	രോമമുള്ള നേർത്ത ഇളം ചർമ്മο
Time and date stamp in corner##airplane,airplane,boat,airplane,boat	കോണിലുള്ള സമയവും തീയതിയും സ്റ്റാമ്പ്
stop sign in english and farsi##person,book,book,book,book,book,book,chair,book,book	ഇംഗ്ലീഷിലും ഫാർസിയിലും സ്റ്റോപ്പ് ചിഹ്നം
second story of house##person,frisbee,person	വീടിന്റെ രണ്ടാമത്തെ സ്റ്റോറി
The stand of the t.v.##bed,book,clock,book	ടിവിയുടെ സ്റ്റാന്റ്
bird second in line##person,tennis racket,sports ball	രണ്ടാം വരിയിലെ പക്ഷി
this couple is on a date##clock	ഈ ദമ്പതികൾ ഒരു ഡേറ്റിലാണ്
base ball opponent players##bed,potted plant,couch,clock	ബേസ് ബോൾ കളിക്കുന്ന എതിരാളി
Laptop on a stand##tennis racket,person,person,tennis racket,chair	ഒരു സ്റ്റാന്റിൽ ലാപ്‌ടോപ്പ്
Knives in a wooden block behind the stove.##person,person,horse,horse,person,person,person,person,person,person	സ്റ്റവ്വിന് പിന്നിലെ ഒരു വുഡൻ ബ്ലോക്കിലെ കത്തികൾ.
the bird is stand on a tree branch##tv,person,remote,person,person,person,person,handbag,book,person	പക്ഷി ഒരു മരക്കൊമ്പിൽ നിൽക്കുന്നു
A sideways rendered date stamp##car,truck,car,motorcycle,car,bus,person,car,traffic light,traffic light	ഒരു വശത്ത് റെൻഡർ ചെയ്ത തീയതി സ്റ്റാമ്പ്
fast pass tickets on bus window##person,train,tv,suitcase,handbag,person,person,car	ബസ്സ് വിൻഡോയിൽ ഫാസ്റ്റ് പാസ് ടിക്കറ്റുകൾ
stamp on boy's left hand##person,person,person,baseball glove,person,person,baseball bat,baseball bat,person	ആൺകുട്ടിയുടെ ഇടതു കൈയിലെ സ്റ്റാമ്പ്
a weed growing up from the tennis court##person,person,person,person,baseball glove,person,person,person,person,person	ടെന്നീസ് കോർട്ടിൽ വളരുന്ന ഒരു കള
Chinese characters on the window##person,sports ball,tennis racket	വിൻഡോയിലെ ചൈനീസ് പ്രതീകങ്ങൾ
long net across the court##bottle,cup,dining table,person,person,cup,cup,refrigerator,person,cup	കോർട്ടിന് കുറുകെ നീളമുള്ള വല
a block on the ground##bottle,sink	നിലത്ത് ഒരു ബ്ലോക്ക്
Man getting ready for a penalty kick##teddy bear,oven,person,train	മനുഷ്യൻ ഒരു പെനാൽറ്റി കിക്കിന് തയ്യാറാകുന്നു
base ball diamond with players##person,tennis racket,sports ball,sports ball,sports ball,sports ball,sports ball,sports ball	കളിക്കാർക്കൊപ്പം ബേസ് ബോൾ ഡയമണ്ട്
two long and narrow panes below cross bar##person,traffic light,traffic light,person,traffic light,car,car,potted plant,car,car	ക്രോസ് ബാറിന് താഴെ നീളമുള്ളതും ഇടുങ്ങിയതുമായ രണ്ട് പാളികൾ
Oriole on front of players hat##traffic light,person,person	കളിക്കാരന്റെ തൊപ്പിക്ക് മുന്നിൽ ഓറിയോൾ
a red cross decal##stop sign,person,skateboard,dining table	ഒരു ചുവന്ന ക്രോസ് ഡെക്കൽ
time and date stamp on the picture##person,person,person,person,clock,book,bird,book,book,book	ചിത്രത്തിലെ സമയവും തീയതിയും ഉള്ള സ്റ്റാമ്പ്
a green fence at a tennis court##giraffe,giraffe,giraffe	ഒരു ടെന്നീസ് കോർട്ടിലെ പച്ച വേലി
yellow sticker with asian characters##person,person,person,tennis racket,person,person,tennis racket,person,person,person	ഏഷ്യൻ പ്രതീകങ്ങളുള്ള മഞ്ഞ സ്റ്റിക്കർ
A large screen with information about the players.##refrigerator,oven,bowl,dining table,knife,orange,fork,knife,knife,knife	കളിക്കാരെക്കുറിച്ചുള്ള വിവരങ്ങളുള്ള ഒരു വലിയ സ്ക്രീൻ.
baseball players dressed in gray and orange##person,bird,bird	ഗ്രേ, ഓറഞ്ച് നിറത്തിലുള്ള ഡ്രസ്സ് ധരിച്ച ബേസ്ബോൾ കളിക്കാർ
sydney written in white letters on court##cup,person,person,umbrella,person,person,person,person,person,person	മൈതാനത്തു വെളുത്ത അക്ഷരങ്ങളിൽ എഴുതിയ സിഡ്നി
A white stand mixer##oven,knife,bottle,bottle,bottle,knife,bottle,bottle,microwave,knife	ഒരു വൈറ്റ് സ്റ്റാൻഡ് മിക്സർ
charger stand on a desk##car,car,car,traffic light,car,car,car	ചാർജർ സ്റ്റാന്റ് ഒരു മേശപ്പുറത്ത്
Another stand and its owner##bus,person,person,person,person,bus,person,person	മറ്റൊരു തട്ടും അതിന്റെ ഉടമയും
White lamp shade on tall stand##train,person,person,traffic light,train,traffic light,traffic light,person,person	ഉയരമുള്ള സ്റ്റാൻഡിൽ വെളുത്ത വിളക്കിന്റെ നിഴൽ
Child sitting cross-legged on the floor##cup,hot dog,oven,dining table	കുട്ടി തറയിൽ ചമ്രം പടഞ്ഞിരിക്കുന്നു
the wave moves fast##airplane,truck,airplane	തിരമാല അതിവേഗം നീങ്ങുന്നു
red characters on top of blue building##elephant,person,person,person,bench	നീല കെട്ടിടത്തിന്റെ മുകളിൽ ചുവന്ന പ്രതീകങ്ങൾ
stand of bamboo##person,person,snowboard,snowboard,skis,skis,snowboard,bicycle,skis	മുളയുടെ കൂട്ടം
a purple umbrella with little cartoon characters##person,suitcase,person,person,person,suitcase,bench,remote,person	ചെറിയ കാർട്ടൂൺ പ്രതീകങ്ങളുള്ള പർപ്പിൾ കുട
the players glove is black##person,sheep,person,tie,sheep,sheep,dog,sheep,dog,dog	കളിക്കാരുടെ കയ്യുറ കറുത്തതാണ്
The water bottle on the side of the court.##person,tennis racket	കോർട്ടിന്റെ വശത്തുള്ള വാട്ടർ ബോട്ടിൽ.
fine metal safety netting##bed,bed	മികച്ച മെറ്റൽ സുരക്ഷാ നെറ്റിംഗ്
two lemons together on a block##train,person	ഒരു ബ്ലോക്കിൽ രണ്ട് നാരങ്ങകൾ
ground where bike stand##person,tennis racket,person,person,person,person,person	ബൈക്ക് നിൽക്കുന്ന സ്ഥലം
black lamp with floor stand##person,person,tennis racket,tennis racket,person,person,sports ball,person,person,person	ഫ്ലോർ സ്റ്റാൻഡുള്ള കറുത്ത വിളക്ക്
this shop sells fine ales##person,tennis racket	ഈ ഷോപ്പ് ഫൈൻ എൻസ് വിൽക്കുന്നു
empire near second base##stop sign,person,person,car,person,person	രണ്ടാമത്തെ അടിത്തറയ്ക്ക് സമീപമുള്ള എംപയർ
players watch from the dugout##person,sports ball,tennis racket,car	ഡഗ ഔട്ടിൽ നിന്ന് കളിക്കാർ കാണുന്നു
second animal in the back##airplane	പിന്നിലെ രണ്ടാമത്തെ മൃഗം
Cement block outdoor flooring.##donut,oven,pizza,donut,oven,cake,hot dog	സിമന്റ് ബ്ലോക്ക് ഔട്ട്‌ഡോർ ഫ്ലോറിംഗ്.
The yellow vase on the second shelf on the right.##bicycle,traffic light,traffic light,person,traffic light,traffic light,car,traffic light,person,person	വലതുവശത്തെ രണ്ടാമത്തെ അലമാരയിലെ മഞ്ഞ അലങ്കാരപാത്രം
dirt ground elephants stand on##person,person,tie,teddy bear,tie	അഴുക്ക് നിലത്തു ആനകൾ നിൽക്കുന്നു
the players in the dugout##oven,oven,sink,oven,oven,oven,bench	ഡഗഔട്ടിലെ കളിക്കാർ
adult on a tennis court##airplane	മുതിർന്നയാൾ ഒരു ടെന്നീസ് കോർട്ടിൽ
date stamp on the photo##person,person,person,person,person,person,person,person,tie,person	ഫോട്ടോയിലെ തീയതി സ്റ്റാമ്പ്
the second young lady is wearing capri-style jeans##person,person,remote,remote,remote,remote,couch,couch,chair,chair	രണ്ടാമത്തെ യുവതി കാപ്രി-സ്റ്റൈൽ ജീൻസ് ധരിക്കുന്നു
cross section of fans at baseball game##teddy bear,person,teddy bear,car,teddy bear,teddy bear,bicycle	ബേസ്ബോൾ ഗെയിമിൽ ആരാധകരുടെ ക്രോസ്സ് സെക്ഷൻ
Photo's date stamp.##train,train,person,person,person,person,person	ഫോട്ടോയുടെ തീയതി സ്റ്റാമ്പ്.
person has fair colored skin##person,person,tennis racket	വ്യക്തിക്ക് നല്ല നിറമുള്ള ചർമ്മമുണ്ട്
the players are on a field##person,person,tennis racket,tennis racket,tennis racket,sports ball	കളിക്കാർ ഒരു കളത്തിലാണ്
baseball players white pants##bottle,wine glass,knife,knife,vase,microwave,wine glass,knife,person,remote	ബേസ്ബോൾ കളിക്കാരന്റെ വൈറ്റ് പാന്റ്സ്
fast food soda cups##person,car,car,car,car,car,car,car,car,car	ഫാസ്റ്റ് ഫുഡ് സോഡ കപ്പുകൾ
coca cola international logo, written in english, probably repeated below##person,person,sports ball,person,tennis racket,chair,tennis racket	കൊക്കകോള ഇന്റർനാഷണൽ ലോഗോ, ഇംഗ്ലീഷിൽ എഴുതിയിരിക്കുന്നു, ഒരുപക്ഷേ ചുവടെ ആവർത്തിക്കുന്നു
gate/door to fence surrounding court##person,bed,teddy bear,bottle,chair	കോർട്ടിന് ചുറ്റുമുള്ള വേലിയിലേക്കുള്ള വാതിൽ / വാതിൽ
characters on the sign##laptop,book,book,cell phone,book,dining table	ചിഹ്നത്തിലെ പ്രതീകങ്ങൾ
toy models of buses##person,person,chair,book,book,book,book,bottle,book,book	ബസ്സുകളുടെ കളിപ്പാട്ട മോഡലുകൾ
second story of building holds two balconies##person,person,person,person,person,person,tennis racket,sports ball,tennis racket,tennis racket	കെട്ടിടത്തിന്റെ രണ്ടാമത്തെ സ്റ്റോറിയിൽ രണ്ട് ബാൽക്കണി ഉണ്ട്
the players tennis shoes are white##traffic light,traffic light,traffic light,stop sign,traffic light,traffic light,kite	കളിക്കാരുടെ ടെന്നീസ് ഷൂസ് വെളുത്തതാണ്
players playing base ball on field##person,person,person,bird,dining table,person,person,person,person,bird	കളിക്കാർ ബേസ് ബാൾ കളിക്കുന്നു
Cars moving at a very fast speed##person,traffic light,train,person,person,person,person,person,person,person	വളരെ വേഗതത്തിൽ സഞ്ചരിക്കുന്ന കാറുകൾ
Television set on wooden stand##person,sports ball,tennis racket,sports ball,sports ball,sports ball,sports ball,sports ball,sports ball	തടി സ്റ്റാൻഡിലെ ടെലിവിഷൻ സെറ്റ്
Helmet on the second horse rider.##traffic light,car,fire hydrant,traffic light	രണ്ടാമത്തെ കുതിര സവാരിക്കാരന്റെ ഹെൽമെറ്റ്.
walking so fast person is captured as a blur##banana,banana,banana,banana,banana,banana,banana,banana,banana,banana	വളരെ വേഗത്തിൽ നടക്കുന്നത് ഒരു മങ്ങലായി പിടിക്കപ്പെട്ടു
A white pot on the stand##person,person,baseball bat,baseball glove,person,person,person,person,person,person	സ്റ്റാൻഡിലെ ഒരു വെളുത്ത കലം
a white stand on road##person,oven,cup,tie,microwave,dining table,oven,knife,bowl,oven	റോഡിൽ ഒരു വെളുത്ത സ്റ്റാൻഡ്
a sign in a zoo, written in catalan - spanish – english##person,backpack,cell phone,backpack,bench,handbag,bench,potted plant	മൃഗശാലയിലെ ഒരു അടയാളം, കറ്റാലൻ - സ്പാനിഷ് - ഇംഗ്ലീഷിൽ എഴുതിയിരിക്കുന്നു
small food press on stove##person,person,person,person,clock,person,person,person,person,person	സ്റ്റോവിൽ ചെറിയ ആഹാരം ഉണ്ടാക്കുന്ന അച്ച്
French coffee press##person,tennis racket,chair,person,person,person,person,person,person,person	ഫ്രഞ്ച് കോഫി പ്രസ്സ്
mass sheep and woolcraft fair ribbon##	കൂട്ട ആടുകളും കമ്പിളി ഫെയർ റിബണും
White paper on a black stand##person,tennis racket,person,person	കറുത്ത സ്റ്റാൻഡിൽ വെള്ള പേപ്പർ
curves of forms worn over shoes on snowboard##person,person,person,baseball glove,baseball glove,cell phone,person,potted plant,cell phone,person	സ്നോബോർഡിൽ ഷൂസിന് മുകളിൽ ധരിക്കുന്ന ഫോമുകളുടെ കർവുകൾ
judge on side of court on blue platform##person,person,person,person,bench,baseball glove,person,person,baseball glove,person	നീല പ്ലാറ്റ്ഫോമിലെ കളിസ്ഥലത്തിന്റെ അരികെ വിധികർത്താവ്
part of the ball field with players getting ready to play##person,person,tv,person,tv,tv,person,laptop,person,tv	കളിക്കാർ കളിക്കാൻ തയ്യാറാകുന്ന ബോൾ ഫീൽഡിന്റെ ഒരു ഭാഗം
a cross street sign##person,person,person,baseball bat,baseball glove,person,chair,chair,person,person	ഒരു ക്രോസ്സ് സ്ട്രീറ്റ് ചിഹ്നം
grass grows next to the block##frisbee,person,person,person,person,umbrella	ബ്ലോക്കിന് അടുത്തായി പുല്ല് വളരുന്നു
english flag printed umbrella##car,car,car,car,truck,car,car,truck,truck	ഇംഗ്ലീഷ് പതാക അച്ചടിച്ച കുട
Blue cross window on second floor##tv,couch,chair,vase,bench,book,book,book,book,potted plant	രണ്ടാം നിലയിലെ നീല ക്രോസ്സ് വിൻഡോ
second set of closed umbrellas##parking meter,parking meter,person,person	അടച്ച കുടകളുടെ രണ്ടാമത്തെ കൂട്ടം
second base found directly behind the pitcher##knife,knife,knife,knife,knife,bowl,bowl,spoon,bowl,knife	പിച്ചറിന് പിന്നിൽ നേരിട്ട് കണ്ടെത്തിയ രണ്ടാമത്തെ അടിത്തറ
green field next to players##truck,chair,person	കളിക്കാർക്ക് അടുത്തുള്ള പച്ച ഫീൽഡ്
white stripes in road is a pedestrian cross walk##person,person,person	റോഡിലെ വെളുത്ത വരകൾ കാൽനടയാത്രക്കാരുടെ ക്രോസ് വാക്ക് ആണ്
white frisbee in players hands##airplane	കളിക്കാരുടെ കൈയിൽ വെളുത്ത ഫ്രിസ്ബീ
block tower on top of hill##person,person,person,person,person,person,baseball glove,backpack,sports ball,baseball glove	കുന്നിൻ മുകളിലെ ബ്ലോക്ക് ടവർ
Brown stand holding bananas.##person,person,person,person,person,person,person,person,person,person	വാഴപ്പഴം പിടിച്ചിരിക്കുന്ന ബ്രൗൺ സ്റ്റാൻഡ്.
a clock on a wooden block##person,person,bed,person,bowl	തടിക്കഷണത്തിലെ ഘടികാരം
Soccer players sitting on a bench##person,person,person,baseball glove,person,person,person,baseball bat,person,person	ഒരു ബെഞ്ചിലിരിക്കുന്ന കാല്പന്ത് കളിക്കാർ
book of forms on desk##boat,surfboard	ഫോമുകളുടെ പുസ്തകം മേശപ്പുറത്ത്
A dirty white dish towel with red cross stripes##person,person,tennis racket,chair,chair,person,person,sports ball,person,person	ചുവന്ന ക്രോസ് വരകളുള്ള വൃത്തികെട്ട വെളുത്ത ഡിഷ് ടൌവൽ
Dirt on the players pants.##person,bench,bench,person,chair,car	കളിക്കാരന്റെ പാന്റിലെ അഴുക്ക്.
white engraved cross##bench,bench,bench,bench,bench	വെളുത്ത കൊത്തുപണി ചെയ്ത കുരിശ്
man on a tennis court on a sunny day##	ഒരു സണ്ണി ദിവസം ടെന്നീസ് കോർട്ടിൽ ഉള്ള മനുഷ്യൻ
wood platform for bird to stand on##person,person,frisbee,person,person,person,person,person,person,person	പക്ഷിക്ക് നിൽക്കാൻ വുഡൻ പ്ലാറ്റ്ഫോം
White second story porch##keyboard,laptop,mouse,cup,cup,person,tv,chair,person,tv	വെളുത്ത രണ്ടാമത്തെ സ്റ്റോറി പോർച്ച്
person setting in second seat of bus##person,person,dining table,vase,bowl,book,bottle	ബസ്സിന്റെ രണ്ടാം സീറ്റിൽ വ്യക്തി ഇരിക്കുന്നു
The second train car##person,tennis racket,sports ball	രണ്ടാമത്തെ ട്രെയിൻ കാർ
a red newspaper stand##person,person,person,person,person,person,person,person,person,person	ഒരു ചുവന്ന പത്ര സ്റ്റാന്റ്
grill press##cat,bowl,bowl,refrigerator	ഗ്രിൽ പ്രസ്സ്
Calendar has star wars characters on it##potted plant,clock	കലണ്ടറിൽ സ്റ്റാർ വാർസ് പ്രതീകങ്ങളുണ്ട്
The car is moving fast.##car,car,car,car,motorcycle,motorcycle,car,car,car,car	കാർ അതിവേഗം നീങ്ങുന്നു.
blue wall of the court##stop sign,truck,car,potted plant	കളിസ്ഥലത്തെ നീല മതിൽ
orange date print##horse,horse,horse,horse,umbrella,person,person,person	ഓറഞ്ച് തീയതി പ്രിന്റ്
front of military plane is pointed and fast##clock,clock,bench,potted plant,fire hydrant	സൈനിക വിമാനത്തിന്റെ മുൻവശം കൂർത്തതും വേഗതയുള്ളതുമാണ്
very fine fabric and material##person,tennis racket,sports ball	വളരെ മികച്ച തുണിത്തരങ്ങളും മെറ്റീരിയലും
railed porch on the second floor of a home##	ഒരു വീടിന്റെ രണ്ടാം നിലയിലെ പൂമുഖം
soccer players red shirt##person,person,person,cake,dining table,chair,dining table,chair,person,cup	സോക്കർ കളിക്കാരുടെ ചുവന്ന ഷർട്ട്
tennis match in progress on outdoor court##person,person,person,person,wine glass,wine glass,wine glass,person,wine glass,chair	വെളിയിലുള്ള ടെന്നീസ് മൈതാനത്തു ടെന്നീസ് മത്സരം പുരോഗമിക്കുന്നു
waves forms behind the boat##clock,car,person,person,horse,person,person,person	ബോട്ടിന് പിന്നിൽ തിരമാലകൾ രൂപം കൊള്ളുന്നു
hedge bush growing outside of the tennis court##train,train	ടെന്നീസ് കോർട്ടിന് പുറത്ത് വളരുന്ന ഹെഡ്ജ് ബുഷ്
Gated street fair##person,baseball glove	ഗേറ്റ് ഉള്ള തെരുവ് മേള
man standing in a tennis court##donut,donut,donut,dining table,donut,cake	ഒരു ടെന്നീസ് കോർട്ടിൽ നിൽക്കുന്ന മനുഷ്യൻ
tennis court floor is blue##tv,chair,mouse,remote,person,chair,person,dining table,clock,keyboard	ടെന്നീസ് കോർട്ട് തറ നീലയാണ്
The second sign says 4 way.##person,tennis racket	രണ്ടാമത്തെ ചിഹ്നം നാല് വഴി പറയുന്നു.
a man trying to cross##person,car,person,person,car,car,bicycle,person,bicycle,person	കടക്കാൻ ശ്രമിക്കുന്ന ഒരാൾ
a fast moving hand##toilet,bottle,sink,sink,chair,sink	വേഗത്തിൽ ചലിക്കുന്ന കൈ
computer monitor on stand##refrigerator,bottle,bottle,bottle,bottle,bottle,bottle,bottle,refrigerator,bottle	സ്റ്റാൻഡിലിരിക്കുന്ന കമ്പ്യൂട്ടർ മോണിറ്റർ
A man taking a picture of the players.##person,surfboard,surfboard	കളിക്കാരുടെ ചിത്രം എടുക്കുന്ന ഒരാൾ.
two players in ground##person,tennis racket,apple	മൈതാനത്ത് രണ്ട് കളിക്കാർ
Thick white wooden cross.##chair,potted plant,cup,cup,vase,dining table,chair,cup,book,bowl	കട്ടിയുള്ള വെളുത്ത തടി കുരിശ്.
a group of game officials at the corner of tennis court##person,person,bicycle,person,bicycle,bicycle,bicycle,person,bicycle,bicycle	ഒരു കൂട്ടം ഗെയിം ഓഫീസർമാർ ടെന്നീസ് കോർട്ടിന്റെ മൂലയിൽ
a red dirt tennis court##vase,potted plant,dining table	ചുവന്ന അഴുക്ക് ഉള്ള ടെന്നീസ് കോർട്ട്
brick building on a city block##person,snowboard	ഒരു സിറ്റി ബ്ലോക്കിലെ ഇഷ്ടിക കെട്ടിടം
gloves are in the players back pocket##train,person	കയ്യുറകൾ കളിക്കാരുടെ പിന്നിലെ പോക്കറ്റിൽ ആണ്
bicycle stamp on road##person,person,person,person,baseball bat,person,person,person,person,baseball bat	റോഡിൽ സൈക്കിൾ സ്റ്റാമ്പ്
The cave the wave forms.##person,person,person,cake,cake,dog,cake,teddy bear,cake,cake	ഗുഹ തരംഗമായി മാറുന്നു.
awning for food stand##	ഭക്ഷണ സ്റ്റാൻറുകൾ
White second hand on the clock.##person,tie,cat,couch,couch	ക്ലോക്കിൽ വെളുത്ത സെക്കന്റ്‌ സൂചി
Knob above knife block##teddy bear,teddy bear,teddy bear,teddy bear,teddy bear,teddy bear,teddy bear,teddy bear	കത്തി ബ്ലോക്കിന് മുകളിൽ കൈപ്പിടി
a lava lamp on stand##person,elephant,giraffe,horse,person,person	സ്റ്റാൻഡിൽ ഒരു ലാവ വിളക്ക്
a non english sign##airplane,airplane,truck,truck,truck,truck,truck,truck,car,truck	ഇംഗ്ലീഷ് അല്ലാത്ത ചിഹ്നം
a motorcycle going fast##traffic light,traffic light,person,person,traffic light,person,person,person,person,traffic light	ഒരു മോട്ടോർ സൈക്കിൾ വേഗത്തിൽ പോകുന്നു
Some people are at the county fair##person,snowboard,snowboard,person,person,person	ചില ആളുകൾ കൗണ്ടി മേളയിൽ ഉണ്ട്
Gray television on stand##person,person,person,baseball glove,person,sports ball	ഗ്രേ ടെലിവിഷൻ സ്റ്റാൻഡിൽ
a small dark brown night stand##knife,dining table	ഒരു ചെറിയ ഇരുണ്ട തവിട്ടുനിറത്തിലുള്ള രാത്രി സ്റ്റാൻഡ്
An audience witnessing a press conference##suitcase,bottle,couch,bottle,backpack,cup,couch,bed,chair	പത്രസമ്മേളനത്തിന് സാക്ഷിയായ പ്രേക്ഷകർ
stand for trays##person,skateboard,person,bicycle,bicycle,person,bottle,bicycle,person	ട്രേകൾക്കായുള്ള തട്ട്
The train is traveling in fair weather##person,person,donut,person,donut,person,person,donut,person,donut	നല്ല കാലാവസ്ഥയിൽ യാത്ര ചെയ്യുന്ന ട്രെയിൻ
a large concrete block##orange,banana,banana,orange,banana,banana,orange,banana,banana,orange	ഒരു വലിയ കോൺക്രീറ്റ് ബ്ലോക്ക്
a second story railing##person,car,bus,car,person,car,car,car,person,person	രണ്ടാമത്തെ സ്റ്റോറി റെയിലിംഗ്
wood block of knives##wine glass,dining table,bowl,carrot,carrot,carrot,carrot,carrot,carrot,carrot	കത്തികൾ വെച്ചിട്ടുള്ള തടികട്ട
The water bottle on the stand##bed,clock,sink	സ്റ്റാൻഡിലെ വാട്ടർ ബോട്ടിൽ
lamp stand light##person,person,person,person,person,person,person,person,person,backpack	വിളക്ക് സ്റ്റാന്റിലെ ലൈറ്റ്
chinese characters on a red vehicle##scissors,suitcase,scissors,remote,suitcase	ചുവന്ന വാഹനത്തിലെ ചൈനീസ് പ്രതീകങ്ങൾ
green grass as tennis court##person,dog,oven,bottle,bottle,bottle,bottle,microwave,bottle,bowl	പച്ച പുല്ല് ടെന്നീസ് കോർട്ടായി
ball on a tennis court##laptop,remote,tv,book,keyboard,book,suitcase	ഒരു ടെന്നീസ് കോർട്ടിൽ പന്ത്
red white and blue truck is at the fair##person,person,horse,horse,horse,horse,person,handbag	ചുവപ്പ് വെള്ള, നീല ട്രക്ക് മേളയിൽ ഉണ്ട്
the players are wearing cleats on their shoes##person,sports ball,tennis racket,sports ball	കളിക്കാർ അവരുടെ ഷൂസിൽ ക്ലീറ്റുകൾ ധരിച്ചിരിക്കുന്നുക്കുന്നു
Small French coffee press.##bench	ചെറിയ ഫ്രഞ്ച് കോഫി പ്രസ്സ്.
Green stand in the snow.##person,baseball bat,person,person,handbag,person,person,tv	മഞ്ഞു വീണ പച്ച സ്റ്റാന്റ്.
Tall date palm##cat,laptop,person,couch,person	ഉയരമുള്ള ഈന്തപ്പന
two people stand next to the boat##train,person,person,person	രണ്ടുപേർ ബോട്ടിന്റെ അരികിൽ നിൽക്കുന്നു
Road block submerged by water##stop sign,stop sign,person,motorcycle,stop sign,stop sign,book	റോഡ് ബ്ലോക്ക് വെള്ളത്തിൽ മുങ്ങി
fine china with flower design##person,sports ball,person,umbrella	പുഷ്പ രൂപകൽപ്പനയുള്ള ഫൈൻ ചൈന
a cross on the top of the building##person,person,person,person,person,person,person,person,person,tennis racket	കെട്ടിടത്തിന്റെ മുകളിൽ ഒരു കുരിശ്
The man's black shadow on the court##person,person,person,traffic light,traffic light,person,handbag,person,person,handbag	മൈതാനത്തു പുരുഷന്റെ കറുത്ത നിഴൽ
Award for state fair pears##person,sports ball,tennis racket,baseball glove	സബർജൻ മേളക്കുള്ള സംസ്ഥാന അവാർഡ്
Baseball player stealing second base##person,skateboard,bicycle,bicycle,potted plant,chair,bench,chair,bench	രണ്ടാം ബേസ് മോഷ്ടിക്കുന്ന ബേസ്ബോൾ കളിക്കാരൻ
Brown tennis court floor##teddy bear,cat	ബ്രൗൺ ടെന്നീസ് കോർട്ട് ഫ്ലോർ
stuffed disney characters##oven,bottle,wine glass,refrigerator,pizza,dining table,spoon,chair	സ്റ്റഫ് ചെയ്ത ഡിസ്നി പ്രതീകങ്ങൾ
a fence between the field and players##person,tennis racket,person,tennis racket	മൈതാനവും കളിക്കാരും തമ്മിലുള്ള വേലി
white TV stand on floor##person,tennis racket,sports ball	വെളുത്ത ടിവി സ്റ്റാൻഡ് തറയിൽ
trunk of elephant forms a C##traffic light,parking meter	ആനയുടെ തുമ്പിക്കൈ ഒരു സി പോലിരിക്കുന്നു
The birds are flying fast##person,person,tennis racket,person,person,person,person,person,tennis racket,sports ball	പക്ഷികൾ വേഗത്തിൽ പറക്കുന്നു
blue wood life guard stand##stop sign	നീല വുഡ് ലൈഫ് ഗാർഡ് സ്റ്റാൻഡ്
white springs under mattress##person,tennis racket,person,person,person,person,person,person,sports ball,tennis racket	കട്ടിൽ കീഴിൽ വെള്ള സ്പ്രിങ്ങുകൾ
Candle on glass candle stand##bench,bench,chair,bench,bench,chair,chair,bench,bench,bench	ഗ്ലാസ് മെഴുകുതിരി സ്റ്റാൻഡിൽ മെഴുകുതിരി
date and time of photo##airplane,airplane,kite	ഫോട്ടോയുടെ തീയതിയും സമയവും
white paper with pictures on stand on the table##person,person,tennis racket,tennis racket,car,car,tennis racket,handbag	മേശപ്പുറത്ത് നിൽക്കുന്ന ചിത്രങ്ങളുള്ള വെളുത്ത പേപ്പർ
concrete block near street.##person,person,person,person,person,person,cup,person,person,banana	തെരുവിനടുത്തുള്ള കോൺക്രീറ്റ് ബ്ലോക്ക്.
Date stamp of photograph##clock,car,clock,car,person	ഫോട്ടോയുടെ തീയതി സ്റ്റാമ്പ്
line where block fit together##person,person,person,person,person,person,person,person,person,person	ബ്ലോക്ക് ഒന്നിച്ച് യോജിക്കുന്ന ലൈൻ
A crack on the court##skateboard,person,person,remote,skateboard	കോർട്ടിൽ ഒരു വിള്ളൽ
red cross with a white background##bus,bus,bus,bus	വെളുത്ത പശ്ചാത്തലമുള്ള ചുവന്ന ക്രോസ്
court attendant sitting in chair##chair,couch,couch,chair,cake,dining table	കോർട്ട് അറ്റൻഡന്റ് കസേരയിൽ ഇരിക്കുന്നു
TV on the stand.##skateboard,person,person,person,person,skateboard,chair,person	സ്റ്റാൻഡിൽ ടിവി.
kids at a fair eating##vase,vase,vase,vase,vase	കുട്ടികൾ മേളയിൽ ഭക്ഷണം കഴിക്കുന്നു
fence around the court.##chair,refrigerator,chair,bottle,potted plant,microwave,bottle,bottle,oven,microwave	കളിസ്ഥലത്തിനു ചുറ്റും വേലി.
series of curved forms around body##airplane	ശരീരത്തിന് ചുറ്റുമുള്ള വളഞ്ഞ രൂപങ്ങളുടെ ശ്രേണി
White door on second floor##person,baseball glove,person,person,person,baseball bat,baseball bat,car	രണ്ടാം നിലയിലെ വെളുത്ത വാതിൽ
yellow numbers showing the date##person,baseball bat,person,person,baseball glove,person,person,person,person	തീയതി കാണിക്കുന്ന മഞ്ഞ നമ്പറുകൾ
Three women soccer players sitting on a bench.##person,person,person,baseball glove,person,person,person,person,person,person	മൂന്ന് വനിതാ സോക്കർ കളിക്കാർ ബെഞ്ചിലിരിക്കുന്നു
Grey block wall behind woman##person,sheep,person,cell phone,dog,person,bench,person,person,cow	സ്ത്രീക്ക് പിന്നിൽ ഗ്രേ ബ്ലോക്ക് മതിൽ
raised cross on top of remote control##airplane	റിമോട്ട് നിയന്ത്രണത്തിന് മുകളിൽ ഉയർത്തിയ ക്രോസ്
seats in the stand##person,person,person,baseball bat,person,baseball glove,person,person,person,person	സ്റ്റാൻഡിലെ സീറ്റുകൾ
Opponent Reaching Out to block##person,frisbee	തടയാൻ എതിരാളി എത്തിച്ചേരുന്നു
Dark colored stand a tv is on.##traffic light,traffic light,traffic light,traffic light,traffic light,traffic light,traffic light,traffic light,traffic light	ഇരുണ്ട നിറമുള്ള സ്റ്റാൻഡിൽ ഒരു ടീവി ഉണ്ട്
Single white line drawn on tennis court##person,person,tennis racket,tennis racket,person,truck	ടെന്നീസ് കോർട്ടിൽ വരച്ച ഒറ്റ വെളുത്ത വര
large orange and green sign giving name and date##person,person,person,person,sports ball,sports ball,tennis racket,person,tennis racket,person	പേരും തീയതിയും നൽകുന്ന വലിയ ഓറഞ്ച്, പച്ച ചിഹ്നങ്ങൾ
black shadow on baseball field beneath baseball players feet##person,person,person,person,sports ball,person,person,person,person,person	ബേസ്ബോൾ കളിക്കാരുടെ കാലുകൾക്ക് താഴെയുള്ള ബേസ്ബോൾ മൈതാനത്തെ കറുത്ത നിഴൽ
Baseball glove on players left hand##person,person	കളിക്കാരുടെ ഇടത് കൈയിലെ ബേസ്ബോൾ കയ്യുറ
rocky and rectangular block with openings on dirt##tv,tv,keyboard,mouse,dining table	പാറയും ചതുരാകൃതിയിലുള്ളതുമായ ബ്ലോക്ക് അഴുക്കുചാലിലേക്ക് തുറക്കുന്നു
green surface surrounding tennis court##person	ടെന്നീസ് കോർട്ടിന് ചുറ്റുമുള്ള പച്ച ഉപരിതലം
The motorcycles are going fast##umbrella,person,tv,bird	മോട്ടോർ സൈക്കിളുകൾ അതിവേഗം പോകുന്നു
photo date on right##person,skis,skis	ഫോട്ടോ തീയതി വലതുവശത്ത്
Right ear of the second cat##airplane,person,person,person,person,person,person,person,person,person	രണ്ടാമത്തെ പൂച്ചയുടെ വലത് ചെവി
two tennis players wearing black shorts##person,person,skis,bench,bench,person,car	കറുത്ത ഷോർട്ട്സ് ധരിച്ച രണ്ട് ടെന്നീസ് കളിക്കാർ
Back right foot of the second goat##stop sign	രണ്ടാമത്തെ ആടിന്റെ വലതു കാൽ
logo on the tennis court##clock,car,clock,clock,truck,car,clock	ടെന്നീസ് കോർട്ടിലെ ലോഗോ
the second engine of the train##person,tennis racket	ട്രെയിനിന്റെ രണ്ടാമത്തെ എഞ്ചിൻ
the stand is stable##person,person,person,person,person,skis,person,person,skis,person	തട്ട് സുസ്ഥിരമാണ്
a horse with an english saddle##zebra,zebra,zebra,zebra,zebra,zebra,zebra	ഒരു ഇംഗ്ലീഷ് സാഡിലുമായി ഒരു കുതിര
a green court##chair,chair,chair,sink,dining table,chair,dining table,chair,bowl,donut	ഒരു പച്ച കോർട്ട്
the yellow block in the parking stall##sandwich,cup,bowl,sandwich,dining table,dining table	പാർക്കിംഗ് സ്റ്റാളിലെ മഞ്ഞ ബ്ലോക്ക്
A table full of fine china.##train,train	ഫൈൻ ചൈന നിറഞ്ഞ ഒരു മേശ.
Cube-like cement block out-building with large square door##person,person,person,person,person,motorcycle,car,car,car,handbag	വലിയ ചതുര വാതിലുള്ള ക്യൂബ് പോലുള്ള സിമന്റ് ബ്ലോക്ക് ഔട്ട്-ബിൽഡിംഗ്
date on the screen##person,banana,banana,banana,bowl,banana,bottle,bottle,bowl,banana	സ്ക്രീനിൽ തീയതി
the stand under the tv##remote,book,remote,carrot	ടിവിയുടെ കീഴിലുള്ള സ്റ്റാന്റ്
child's soft fine brown hair##airplane,airplane,airplane	കുട്ടിയുടെ മൃദുവായ നേർത്ത തവിട്ട് നിറമുള്ള മുടി
date the photo was taken##person,person,person,person,baseball bat,sports ball,baseball glove,baseball glove,baseball glove,baseball bat	ഫോട്ടോ എടുത്ത തീയതി
characters apart on stage set##clock,clock,boat	സ്റ്റേജ് സെറ്റിലെ പ്രതീകങ്ങൾ
A ball girl at the back of a tennis court##person,motorcycle,person,car,car,car,car,car,backpack,truck	ഒരു ടെന്നീസ് കോർട്ടിന്റെ പിൻഭാഗത്തുള്ള ഒരു ബോൾ പെൺകുട്ടി
wave is moving fast##horse,horse	തിരമാല അതിവേഗം നീങ്ങുന്നു
woman is behind the white line of a tennis court##bicycle,bicycle,person,motorcycle,person	ഒരു ടെന്നീസ് കോർട്ടിന്റെ വെളുത്ത വരയ്ക്ക് പിന്നിലാണ് സ്ത്രീ
security forces vehicle with open windows##traffic light,bus,person,car,person,traffic light,car,car,car,person	തുറന്ന ജാലകങ്ങളുള്ള സുരക്ഷാ സേനാ വാഹനം
characters on the edge of the plate##bed	പ്ലേറ്റിന്റെ അരികിലുള്ള പ്രതീകങ്ങൾ
ad on the wall of the court##person,tennis racket,person,person,person,person,person,bottle,person	കോർട്ടിന്റെ ചുമരിൽ പരസ്യം
a white line cross walk.##person,surfboard,person,person	ഒരു വൈറ്റ് ലൈൻ ക്രോസ് വാക്ക്.
dirty concrete wall behind players##person,person,skis,skis,person	കളിക്കാർക്ക് പിന്നിൽ വൃത്തികെട്ട കോൺക്രീറ്റ് മതിൽ
press board table top##	പ്രസ്സ് ബോർഡ് ടേബിൾ ടോപ്പ്
The canvas sits on the stand##person,car,truck,person,car,car,person,umbrella,person,person	ക്യാൻവാസ് സ്റ്റാൻഡിൽ ഇരിക്കുന്നു
people eating fast food##person,frisbee	ആളുകൾ ഫാസ്റ്റ് ഫുഡ് കഴിക്കുന്നു
cross on the church roof##chair,keyboard,chair,tv,tv,person,mouse,mouse,person,bottle	പള്ളി മേൽക്കൂരയിൽ കുരിശ്
the english muffins are toasted##person,person,person,person,skis,skis,person,person,parking meter,skis	ടോസ്റ്റുചെയ്ത ഇംഗ്ലീഷ് മഫിനുകൾ
the second level of the bus##boat,train,train,boat,car	ബസിന്റെ രണ്ടാം ലെവൽ
making a very fast turn##chair,book,book	വളരെ വേഗത്തിൽ തിരിയുന്നു
time and date stamp##person,tennis racket,person,person,chair,tennis racket,chair,chair,kite,person	സമയവും തീയതിയും സ്റ്റാമ്പ്
second place is wearing yellow##person,person,person,baseball bat,baseball glove,baseball bat,baseball glove,person,baseball glove,baseball glove	രണ്ടാം സ്ഥാനം മഞ്ഞയാണ് ധരിച്ചിരിക്കുന്നത്
White candle on a stand##remote,remote,couch,laptop,book,bottle,couch,dining table,cat,cup	ഒരു സ്റ്റാൻഡിൽ വെളുത്ത മെഴുകുതിരി
a black second hand##cow,umbrella	ഒരു കറുത്ത സെക്കൻഡ് ഹാൻഡ്
sign denoting 2900 block##person,baseball glove	2900 ബ്ലോക്കിനെ സൂചിപ്പിക്കുന്ന ചിഹ്നം
white fast logo in corner##sink,bottle,bench,vase	മൂലയിലെ വെളുത്ത ഫാസ്റ്റ് ലോഗോ
second bird on right##clock,chair	വലതുവശത്ത് രണ്ടാമത്തെ പക്ഷി
Dollar amount of the penalty.##tennis racket,person,person,person,tennis racket,person,tennis racket,chair,chair,chair	പിഴയുടെ ഡോളർ തുക.
player running on court##person,motorcycle,cell phone,cell phone,tie	കളിക്കാരൻ കോർട്ടിൽ ഓടുന്നു
the fine is 350 usd##bus,person,person,car,car,traffic light,traffic light,handbag,person,car	പിഴ മൂന്നൂറ്റി അമ്പത് യുഎസ്ഡി
long fine hairs on chin##person,tennis racket,tennis racket	താടിയിൽ നീളമുള്ള നേർത്ത രോമങ്ങൾ
Television in the tv stand.##cup,person,person,chair,chair,potted plant,dining table,chair,frisbee,chair	ടിവി സ്റ്റാൻഡിലെ ടെലിവിഷൻ.
A brick wall separating players and spectators.##person,person,chair,sports ball,tennis racket,chair,car,person,chair,bottle	കളിക്കാരെയും കാണികളെയും വേർതിരിക്കുന്ന ഒരു ഇഷ്ടിക മതിൽ.
a cross is on the tower##bus,car,car	ഗോപുരത്തിൽ ഒരു കുരിശുണ്ട്
score card being held by a man on tennis court##person,tennis racket	സ്‌കോർ കാർഡ് ടെന്നീസ് കോർട്ടിൽ ഒരാൾ കൈവശം വച്ചിരിക്കുന്നു
Land forms in the distance##person,horse,person,person,person,person,person,person,person,person	ദൂരത്തുള്ള ഭൂമി രൂപങ്ങൾ
really fast moving hand##umbrella,umbrella,umbrella,umbrella,umbrella,boat,umbrella,umbrella,umbrella,boat	ശരിക്കും വേഗത്തിൽ നീങ്ങുന്ന കൈ
An old wooden stand shade##person,person,person,surfboard,surfboard,person,surfboard,frisbee,surfboard,person	ഒരു പഴയ തടി സ്റ്റാൻഡ് ഷേഡ്
this court is green##person,person,person,person,person,baseball bat,person,chair,bottle,chair	ഈ കോർട്ട് പച്ചയാണ്
Black hat with a red cross##person,tennis racket,person,person,person,sports ball,chair,chair,chair,chair	ചുവന്ന കുരിശുള്ള കറുത്ത തൊപ്പി
Blue characters on a white background##person,baseball glove	വെളുത്ത പശ്ചാത്തലത്തിൽ നീല പ്രതീകങ്ങൾ
oranges and pears on the second layer of a fruit tree rack##horse,horse,person,person,dog,boat	ഒരു ഫ്രൂട്ട് ട്രീ റാക്കിന്റെ രണ്ടാമത്തെ തട്ടിൽ ഓറഞ്ചും പിയറും
Shadow of the man on the tennis court##person,boat,kite,umbrella,backpack,boat,chair,suitcase,car,boat	ടെന്നീസ് കോർട്ടിലെ മനുഷ്യന്റെ നിഴൽ
the second base coach watches the play##tv,traffic light,suitcase	രണ്ടാമത്തെ അടിസ്ഥാന പരിശീലകൻ കളി കാണുന്നു
brown mane on neck of second giraffe##person,person,tennis racket,tennis racket,car	രണ്ടാമത്തെ ജിറാഫിന്റെ കഴുത്തിൽ തവിട്ട് നിറമുള്ള കുഞ്ചിരോമം
name and website of photographer and Chinese characters##person,orange,banana,orange,orange,apple,banana,apple,orange,orange	ഫോട്ടോഗ്രാഫറുടെയും ചൈനീസ് പ്രതീകങ്ങളുടെയും പേരും വെബ്‌സൈറ്റും
A fruit stand on the sidewalk##hot dog,hot dog,hot dog,hot dog,hot dog,hot dog,hot dog,hot dog,hot dog,hot dog	ഫുട്പാത്തിൽ ഒരു ഫ്രൂട്ട് സ്റ്റാന്റ്
cap on players head##clock	കളിക്കാരന്റെ തലയിലെ തൊപ്പി
The black baseball mit on the players hand##book,cup,book,book,book,book,book,book,book,book	കളിക്കാരുടെ കൈയിലുള്ള കറുത്ത ബേസ്ബോൾ മിറ്റ്
a music stand on a curb##bed,chair,chair,remote,dining table	ഒരു സംഗീത സ്റ്റാൻഡ്
A window on a second story shop.##zebra	രണ്ടാമത്തെ സ്റ്റോറി ഷോപ്പിലെ ഒരു വിൻഡോ.
Woman on a tennis court##clock	ഒരു ടെന്നീസ് കോർട്ടിൽ സ്ത്രീ
The players are giving a high five##tennis racket,book,clock,vase,book,book,person,refrigerator	കളിക്കാർ ഹൈ ഫൈവ് നൽകുന്നു
red time stamp on the photo##person,surfboard,surfboard,surfboard,surfboard,surfboard,frisbee,potted plant,sheep,bird	ഫോട്ടോയിലെ ചുവന്ന സമയ സ്റ്റാമ്പ്
A light reflecting on a tie press.##cat,cat,car	ടൈ പ്രസ്സിൽ പ്രതിഫലിക്കുന്ന ഒരു പ്രകാശം.
yellow front of second train##cup,toothbrush,bottle,cup,toothbrush,dining table,cell phone,apple,toothbrush	രണ്ടാമത്തെ ട്രെയിനിന്റെ മഞ്ഞ ഫ്രണ്ട്
shadows of players on court##motorcycle,person	കോർട്ടിലെ കളിക്കാരുടെ നിഴലുകൾ
banana on the stand##person,person,person,person,baseball bat,baseball glove,person,person,person,person	സ്റ്റാന്റിലെ വാഴപ്പഴം
The sole of a second green shoe.##cup,sandwich,sandwich,person,dining table,sandwich,spoon	രണ്ടാമത്തെ പച്ച ഷൂവിന്റെ അടിഭാഗം
window on second level##laptop,laptop,backpack,backpack,backpack,handbag,backpack,backpack,suitcase,bottle	രണ്ടാം ലെവലിൽ വിൻഡോ
the tennis court is made of grass##person,umbrella,person,person,umbrella,person,person,person,bench,person	ടെന്നീസ് കോർട്ട് പുല്ലുകൊണ്ട് നിർമ്മിച്ചതാണ്
this sign is not in english##person,person,person,person,person,sports ball,person,person,person,chair	ഈ അടയാളം ഇംഗ്ലീഷിലില്ല
a cross on the front of a church##clock	ഒരു പള്ളിയുടെ മുൻവശത്ത് ഉള്ള ഒരു കുരിശ്
ovan kept in the stand##car,traffic light,traffic light,person,car,car,car,person,car,car	ഓവൻ സ്റ്റാൻഡിൽ വെച്ചിരിക്കുന്നു
Electrical wire stand##	ഇലക്ട്രിക്കൽ വയർ സ്റ്റാൻഡ്
A red cross forms on the floor.##skateboard,bicycle,clock,bicycle,car,bicycle,truck,book	തറയിൽ ഒരു ചുവന്ന കുരിശ് രൂപം കൊള്ളുന്നു
This part of the court is blue##clock,scissors,scissors	കോർട്ടിന്റെ ഈ ഭാഗം നീലയാണ്
Angels overlooking the cross##train,clock	ഉയരത്തിൽ നിന്ന് കുരിശിനെ നോക്കുന്ന മാലാഖാമാർ
surfboard forms a splash of water##person,person,person,person,person,person,person,person,person,sports ball	സർഫ്ബോർഡ് വെള്ളം തെറിപ്പിക്കുന്നു
light stand beside bed##train,person	കട്ടിലിന് സമീപം ലൈറ്റ് സ്റ്റാൻഡ്
black metal fence behind a tennis court##	ഒരു ടെന്നീസ് കോർട്ടിന് പിന്നിൽ കറുത്ത മെറ്റൽ വേലി
A stand of trees.##person,clock,chair,clock,person,cup,chair,bottle,bicycle,person	മരങ്ങളുടെ സ്റ്റാന്റ്.
information stamp on image##person,orange,orange,cup,cup,orange,orange,orange,orange,baseball bat	ചിത്രത്തിലെ വിവര സ്റ്റാമ്പ്
white sign with blue asian characters on it##potted plant,potted plant,potted plant,potted plant,potted plant,potted plant,potted plant,potted plant,potted plant,potted plant	നീല ഏഷ്യൻ പ്രതീകങ്ങളുള്ള വെളുത്ത ചിഹ്നം
fine grey gravel under players' legs##clock	കളിക്കാരുടെ കാലുകൾക്ക് കീഴിലുള്ള ചാരനിറത്തിലുള്ള ചരൽ
second suitcase on bottom is orange##refrigerator,refrigerator	ചുവടെയുള്ള രണ്ടാമത്തെ സ്യൂട്ട്കേസ് ഓറഞ്ച് ആണ്
plants behind toy models##train	കളിപ്പാട്ട മോഡലുകൾക്ക് പിന്നിലുള്ള സസ്യങ്ങൾ
older dude on bicycle in a country where spanish/english are the official languages##person,person,person,baseball glove,person,person,person,person,person,baseball glove	സ്പാനിഷ് / ഇംഗ്ലീഷ് ഔദ്യോഗിക ഭാഷകളുള്ള രാജ്യത്ത് സൈക്കിളിൽ പഴയ സുഹൃത്ത്
the weather is fair##person,tennis racket,tennis racket	കാലാവസ്ഥ നല്ലതാണ്
tail fine view of a red plane##person,person,skis,person,skis,person	ചുവന്ന വിമാനത്തിന്റെ ലംബമായ വാൽഘടനയുടെ ഭാഗമായ ഒരു സ്റ്റെബിലൈസർ
zebras stand close together to watch for predators##person,person,tennis racket,tennis racket,person,person,person,person,sports ball,sports ball	വേട്ടക്കാരെ നിരീക്ഷിക്കാൻ സീബ്രകൾ ഒരുമിച്ച് നിൽക്കുന്നു
Black stand with microphone##person,person,sports ball,person,tennis racket,person	മൈക്രോഫോണുള്ള കറുത്ത സ്റ്റാൻഡ്
The second highest rail of the jump##cup,cup,vase,dog,potted plant,cup,vase	ചാടാനുള്ള രണ്ടാമത്തെ ഉയർന്ന റെയിൽ
Old english writing on board##cup,sandwich,dining table	ബോർഡിലെ പഴയ ഇംഗ്ലീഷ് എഴുത്ത്
black armed forces name on wing##person,vase	കറുത്ത സായുധ സേനയുടെ പേര് ചിറകിൽ
a sign showing cross streets##person,person,tennis racket,person,person,person,person,person,potted plant,sports ball	ക്രോസ് സ്ട്രീറ്റുകൾ കാണിക്കുന്ന ഒരു അടയാളം
a stand of snow covered trees##bus,car,person,person,person,person,bus,person,person,person	മഞ്ഞുമൂടിയ മരങ്ങളുടെ ഒരു സ്റ്റാന്റ്
Silver cross necklace##bus,car,traffic light,motorcycle,person,person,traffic light,person,person,person	സിൽവർ ക്രോസ്സ് നെക്ലേസ്
Date stamp 6/30/2013##clock,clock	തീയതി സ്റ്റാമ്പ് 6/30/2013
blue court on the ground##person,baseball glove,sports ball	നിലത്ത് നീല കോർട്ട്
The sign is in arabic and english##tie,tie,tie,tie,tie,tie,tie,tie	ചിഹ്നം അറബിയിലും ഇംഗ്ലീഷിലും ആണ്
open door of a second bus##person,baseball glove,person,person,person,person,person	രണ്ടാമത്തെ ബസിന്റെ തുറന്ന വാതിൽ
the date and time indicating the time of picture##giraffe,giraffe,person,person,person,person,person,person,person,person	ചിത്രത്തിന്റെ സമയം സൂചിപ്പിക്കുന്ന തീയതിയും സമയവും
the angel is holding a cross shield##cow,cow,cow,person,person,person,person,person,person,person	മാലാഖ ഒരു ക്രോസ് ഷീൽഡ് പിടിച്ചിരിക്കുന്നു
Baseball travelling fast in the air##person,bicycle,book,tv,book,tv,book,book,book,book	ബേസ്ബോൾ വായുവിൽ വേഗത്തിൽ സഞ്ചരിക്കുന്നു
date stamp that reads 12/04/2010##person,tennis racket,car,sports ball	12/04/2010 കാണുന്ന തീയതി സ്റ്റാമ്പ്
Safety railing on second story of building##person,person,person,sports ball,tennis racket,clock,tennis racket,tennis racket	കെട്ടിടത്തിന്റെ രണ്ടാം നിലയിലെ സുരക്ഷാ റെയിലിംഗ്
Chinese characters on the back of the truck##cake,dining table,cake	ട്രക്കിന്റെ പുറകിലുള്ള ചൈനീസ് പ്രതീകങ്ങൾ
chinese characters on the side of a bus##banana,banana,banana,person,banana,banana,teddy bear,banana,banana,banana	ഒരു ബസ്സിന്റെ വശത്തുള്ള ചൈനീസ് പ്രതീകങ്ങൾ
tail of elephant forms a circle##horse,person,horse,person,person,person,truck,person,truck,truck	ആനയുടെ വാൽ ഒരു വൃത്തമായി മാറുന്നു
cross country ski racers skiing up a hill.##giraffe	ക്രോസ് കൺട്രി സ്കൈ റേസർമാർ ഒരു കുന്നിൻ മുകളിലേക്ക് സ്കീയിംഗ് നടത്തുന്നു.
Tall lights at the court##person,tennis racket,person,person,person,person,person,person,person,person	കോർട്ടിലെ ഉയരമുള്ള ലൈറ്റുകൾ
block of black butcher knives##person,tennis racket,sports ball	കറുത്ത കശാപ്പ് കത്തികളുടെ ബ്ലോക്ക്
man sitting in fruit stand##person,person,person,person,person,person,baseball glove,person,baseball bat,car	ഫ്രൂട്ട് സ്റ്റാൻഡിൽ ഇരിക്കുന്ന മനുഷ്യൻ
Cartoon characters on his shirt##bus,bus,bus,bus,bus,bus,bus,bus,bus,bus	അവന്റെ ഷർട്ടിൽ കാർട്ടൂൺ കഥാപാത്രങ്ങൾ
a stand next to the sink##potted plant,knife,knife,chair,chair,chair,chair	സിങ്കിനടുത്തുള്ള ഒരു തട്ട്
a second meal plate.##elephant,person,person,person,person,umbrella,elephant,bench,person,person	രണ്ടാമത്തെ ഭക്ഷണ പ്ലേറ്റ്.
five baseball players##cup,sandwich,sandwich,dining table,apple	അഞ്ച് ബേസ്ബോൾ കളിക്കാർ
an unfinished block of wood##dog,horse	പണി പൂർത്തിയാകാത്ത തടിക്കഷ്ണം
antique golf clubs and stand##cat	പുരാതന ഗോൾഫ് ക്ലബ്ബുകളും സ്റ്റാൻഡും
A motorcycle kick stand.##clock,clock,refrigerator	ഒരു മോട്ടോർസൈക്കിളിന്റെ കിക്ക് സ്റ്റാൻഡ്.
Curled metal legs on a candle stand##bus,car,person,person,bus,person,person,person	ഒരു ചുരുണ്ട ലോഹ കാലുകൾ ഉള്ള മെഴുകുതിരി സ്റ്റാന്റ്
Woman in an english style saddle##dog,truck,car,person	ഇംഗ്ലീഷ് ശൈലിയിലുള്ള സാഡിലിൽ സ്ത്രീ
pizza on a butcher block table##person,person,bench,handbag,car	ഒരു കശാപ്പ് ബ്ലോക്ക് ടേബിളിൽ പിസ്സ
A wooden block holding up the boat##oven,sink,spoon,spoon,knife,sink,sink,refrigerator,knife	ബോട്ട് ഉയർത്തിപ്പിടിക്കുന്ന ഒരു വുഡൻ ബ്ലോക്ക്
A tennis player standing in the court##person,traffic light	ഒരു ടെന്നീസ് കളിക്കാരൻ കോർട്ടിൽ നിൽക്കുന്നു
Silver metal monitor stand##potted plant	സിൽവർ മെറ്റൽ ഉള്ള മോണിറ്റർ സ്റ്റാൻഡ്
fast motion image of woman walking in rain##person,person,person,person,bus,train,handbag	മഴയിൽ നടക്കുന്ന സ്ത്രീയുടെ ഫാസ്റ്റ് മോഷൻ ചിത്രം
a watermark and date##person,person,person,person,person,person,person,person,person,boat	ഒരു വാട്ടർമാർക്കും തീയതിയും
date and time stamp##person,person,person,person,person,traffic light,car,person,person,person	തീയതി, സമയ സ്റ്റാമ്പ്
fine inscriptions on item##bicycle,person,person,person,person,motorcycle,parking meter,handbag,sports ball	ഇനത്തിലെ മികച്ച ലിഖിതങ്ങൾ
The fast moving subway train##person,sports ball,tennis racket	വേഗത്തിൽ നീങ്ങുന്ന സബ്‌വേ ട്രെയിൻ
rusty springs beneath 'schwinn'##umbrella,person,car,car,handbag,car,handbag,chair,potted plant,potted plant	'ഷ്വിന്നി'ന് ചുവടെയുള്ള തുരുമ്പിച്ച സ്പ്രിങ്ങുകൾ
This is a picture of Chinese characters##person,tennis racket,sports ball,sports ball,sports ball	ചൈനീസ് പ്രതീകങ്ങളുടെ ചിത്രമാണിത്
a couple of elephants photoshopped to stand out##airplane	വേറിട്ടുനിൽക്കുന്ന ആനകളുടെ ഫോട്ടോഷോപ്പ്
Paper forms on the table.##person,person,person,person,person,person,cake,person,remote	ടേബിളിൽ പേപ്പർ ഫോമുകൾ.
white Arabic characters on sign##person,suitcase,couch,potted plant,suitcase,bowl,vase,bowl,dining table,couch	ചിഹ്നത്തിൽ വെളുത്ത അറബി ചിഹ്നം
block on the pole##motorcycle	തടിക്കട്ടയിലെ ധ്രുവം
fork under english muffin##person,tie,tie,bottle	ഇംഗ്ലീഷ് മഫിന് കീഴിലുള്ള ഫോർക്ക്
two young softball players sitting on the bench##bed,bed	രണ്ട് യുവ സോഫ്റ്റ്ബോൾ കളിക്കാർ ബെഞ്ചിൽ ഇരിക്കുന്നു
fence on a baseball court##person,person,person,person,tennis racket,sports ball,person,tennis racket	ഒരു ബേസ്ബോൾ കോർട്ടിലെ വേലി
a cross on the top of the church##person,toothbrush,sink,bottle	പള്ളിയുടെ മുകളിൽ ഒരു കുരിശ്
Bird models suspended in shopping mall.##person,tennis racket,sports ball,tennis racket,frisbee	ഷോപ്പിംഗ് മാളിൽ പക്ഷിയുടെ മോഡലുകൾ തൂക്കി ഇട്ടിരിക്കുന്ന
the tennis court is made up of sand and dirt##vase,vase,chair,potted plant,potted plant,dining table,vase	ടെന്നീസ് കോർട്ട് മണലും അഴുക്കും ചേർന്നതാണ്
characters on the billboard##person,person,person,person,person,person,person,person,truck,person	പരസ്യബോർഡിലെ പ്രതീകങ്ങൾ
date book with plastic cover##person,person,person,person,baseball bat,person,person,baseball bat,person,person	പ്ലാസ്റ്റിക് കവറുള്ള തീയതി പുസ്തകം
Three players are wearing helmet.##person,surfboard,person,person,person,person,person,person,person,person	മൂന്ന് കളിക്കാർ ഹെൽമെറ്റ് ധരിച്ചിരിക്കുന്നു
Wooden butcher block on kitchen sink.##person,tie,baseball glove	അടുക്കള സിങ്കിൽ കശാപ്പ് ചെയ്യുന്ന തടിക്കട്ട
a fair weather cloud##horse,horse,horse,person,person,horse,person,person,person,person	നല്ല കാലാവസ്ഥാ മേഘം
a metal stand for the flowers##person,person,person	പൂക്കൾക്ക് ഒരു മെറ്റൽ സ്റ്റാൻഡ്
Date stamp of March 16th, 2008##bird,kite,umbrella,bird	2008 മാർച്ച് 16 ലെ തീയതി സ്റ്റാമ്പ്
A block wall is behind the skate park##motorcycle,motorcycle,potted plant,potted plant	സ്കേറ്റ് പാർക്കിന് പിന്നിൽ ഒരു ബ്ലോക്ക് മതിൽ ഉണ്ട്
wheels of train with springs##person,skis,skis	സ്പ്രിങ്ങുകൾ ഉള്ള ട്രെയിനിന്റെ ചക്രങ്ങൾ
dog forms splashes in the water##person,cell phone,cell phone,cell phone,cell phone,cell phone,cell phone,person,cell phone,parking meter	നായ വെള്ളം തെറിപ്പിക്കുന്നു
Booths at a street fair.##person,train,truck,person,bus,person	ഒരു തെരുവ് മേളയിലെ ബൂത്തുകൾ.
a cross country skier bending low##person,tennis racket,sports ball,sports ball,sports ball,sports ball,sports ball,sports ball,sports ball	ഒരു ക്രോസ് കൺട്രി സ്കീയർ വളയുന്നു
There is a book stand that is filled with books.##person,tennis racket	പുസ്തകങ്ങളാൽ നിറഞ്ഞ ഒരു പുസ്തക സ്റ്റാൻഡുണ്ട്.
A TV stand sitting under TV##broccoli,person,bowl,broccoli,dining table,chair,person,cake,dining table	ടിവിയുടെ കീഴിൽ ഇരിക്കുന്ന ഒരു ടിവി സ്റ്റാൻഡ്
short tan entertainment stand##person,person,person,person,person,person,baseball glove,person,person,baseball bat	ചെറിയ ടാൻ വിനോദ സ്റ്റാന്റ്
small child cross country skiing##suitcase,suitcase,suitcase,suitcase,suitcase,person,suitcase,suitcase,umbrella,suitcase	ചെറിയ കുട്ടി ക്രോസ് കൺട്രി സ്കീയിംഗ്
a man stand on dock##snowboard,person,person,person	ഒരാൾ കപ്പലിൽ നിൽക്കുന്നു
a fast food ordering bar##train,train,person	ഒരു ഫാസ്റ്റ് ഫുഡ് ഓർഡറിംഗ് ബാർ
a blue wall beside tennis court##person,sports ball,baseball glove,person	ടെന്നീസ് കോർട്ടിന് സമീപം ഒരു നീല മതിൽ
a cross in a church##person,person,person,person,tennis racket,person,person,person,person,person	ഒരു പള്ളിയിലെ ഒരു കുരിശ്
an American flag in the background of a press conference##car,car,car,car,car,car,traffic light,potted plant,train,traffic light	പത്രസമ്മേളനത്തിന്റെ പശ്ചാത്തലത്തിൽ ഒരു അമേരിക്കൻ പതാക
models of airplanes on the tables##person,person,baseball glove,person,person,person,person,person,person,person	ടേബിലിലെ വിമാനങ്ങളുടെ മോഡലുകൾ
sharp knife on the chopping block##sandwich,cell phone,bowl,dining table	ചോപ്പിംഗ് ബ്ലോക്കിലെ മൂർച്ചയുള്ള കത്തി
A small food stand on wheels.##person,person,person,motorcycle,person,motorcycle,motorcycle,motorcycle	ചക്രങ്ങളിൽ ഒരു ചെറിയ ഭക്ഷണ സ്റ്റാൻഡ്.
man in a white hat on the tennis court##person,person,pizza,pizza,person,person,person,cup,vase,knife	ടെന്നീസ് കോർട്ടിൽ വെളുത്ത തൊപ്പി ധരിച്ച മനുഷ്യൻ
White potted flowers on the tennis court##elephant,cow,potted plant,cow,potted plant	ടെന്നീസ് കോർട്ടിൽ വെളുത്ത പൂക്കൾ ഉള്ള ചെടിച്ചട്ടി
fine stitching on leash##tv,person,chair,couch,book,chair,bottle,refrigerator,chair,book	തോൽവാറിലെ മികച്ച തുന്നൽ
yellow stamp date near bottom##person,tennis racket,sports ball	മഞ്ഞ സ്റ്റാമ്പിലെ തീയതി ചുവടെ
pelican forms ripples with legs##person,person,person,motorcycle,motorcycle,person,person,motorcycle	പെലിക്കൻ കാലുകൾ ഉപയോഗിച്ച് അലകൾ ഉണ്ടാക്കുന്നു
The bench the players are sitting on.##person,person,person,baseball bat,bench,sports ball,traffic light,person,baseball bat,baseball glove	കളിക്കാർ ഇരിക്കുന്ന ബെഞ്ച്.
egg shaped object on a stand##person,tv,person,person,person,tv,person,person,person,person	സ്റ്റാന്റിലെ മുട്ടയുടെ ആകൃതിയിലുള്ള വസ്തു
pair of hands typing fast on keyboard##person,person,person,orange,apple,apple,handbag,person,orange,orange	കീബോർഡിൽ വേഗത്തിൽ ടൈപ്പുചെയ്യുന്ന രണ്ടു കൈകൾ
Baby fine light brown hair.##elephant	ബേബിയുടെ നേർത്ത ഇളം തവിട്ട് നിറമുള്ള മുടി.
A bed plastic stamp##tv,chair,chair,chair,dining table,chair,chair,dining table,book,chair	ഒരു ബെഡ് പ്ലാസ്റ്റിക് സ്റ്റാമ്പ്
a stand with information##person,tie	വിവരങ്ങളുള്ള ഒരു സ്റ്റാന്റ്
man working at stand##person,person,person	സ്റ്റാന്റിൽ ജോലി ചെയ്യുന്ന മനുഷ്യൻ
springs of the seat##microwave,oven,knife,sink,knife,oven,sink,knife,oven,sink	ഇരിപ്പിടത്തിന്റെ സ്പ്രിങ്ങുകൾ
black TV stand with flat screen##umbrella,person,person,person,umbrella,person,person,person,car,person	ഫ്ലാറ്റ് സ്ക്രീനുള്ള കറുത്ത ടിവി സ്റ്റാൻഡ്
second seat on motorcycle##bed,chair,tv	മോട്ടോർ സൈക്കിളിൽ രണ്ടാമത്തെ സീറ്റ്
12/22/2006 date stamp##person,bus,train	12/22/2006 തീയതി സ്റ്റാമ്പ്
Concrete forms in pavement##car,car,car,truck,car,person,car,person,person,person	നടപ്പാതയിൽ കോൺക്രീറ്റ് രൂപങ്ങൾ
time stamp on the picture##motorcycle,person,person,person,person,person,person,motorcycle,handbag,car	ചിത്രത്തിലെ ടൈം സ്റ്റാമ്പ്
the cross on the top of the building structure##traffic light,traffic light,bus,car,person,person,traffic light,person,person,traffic light	കെട്ടിട ഘടനയുടെ മുകളിലുള്ള കുരിശ്
sunglasses of second rider##person,car,car,person,car,car,person,car,person,car	രണ്ടാമത്തെ റൈഡറിന്റെ സൺഗ്ലാസുകൾ
A block in the wall.##person,person,cup,cake,sink,chair,cup,cell phone,dining table,dining table	ചുമരിൽ ഒരു ബ്ലോക്ക്.
A round concert block##traffic light,traffic light,train	ഒരു റൗണ്ട് കൺസേർട്ട് ബ്ലോക്ക്
cross that sits atop the column on the left side##sink,bottle	ഇടതുവശത്തുള്ള നിരയുടെ മുകളിൽ ഇരിക്കുന്ന ക്രോസ്സ്
location characters are white##boat,boat	ലൊക്കേഷൻ പ്രതീകങ്ങൾ വെളുത്തതാണ്
black utensils in a wooden block##person,pizza,person,person,person,car,person,pizza,person,person	ഒരു വുഡൻ ബ്ലോക്കിലെ കറുത്ത പാത്രങ്ങൾ
People at a fair.##giraffe,giraffe	ഒരു മേളയിൽ ആളുകൾ.
a brown horse with an english saddle##bottle,bottle,knife,dining table,knife,hot dog,knife,sandwich	ഒരു തവിട്ടുനിറത്തിലുള്ള കുതിരയും കുതിരച്ചേണയും
photographers watermark and date##train,traffic light,traffic light,traffic light,traffic light,traffic light	ഫോട്ടോഗ്രാഫരുടെ വാട്ടർമാർക്കും തീയതിയും
a person cross country skiing in the background##person,potted plant,chair,chair,potted plant,toothbrush,toothbrush	പശ്ചാത്തലത്തിൽ ഒരു വ്യക്തി ക്രോസ്സ് കൺട്രി സ്കീയിംഗ് ചെയ്യുന്നു
date 2008 printed on the label##person,person,person,person,tennis racket,tennis racket,tennis racket	തീയതി 2008 ലേബലിൽ അച്ചടിച്ചു
Tray of white rice and english muffins##person,surfboard,chair	വെളുത്ത അരിയുടെയും ഗോതമ്പപ്പത്തിന്റെയും ട്രേ
Red and silver sign with Asian characters##person,person,person,baseball bat,person,baseball glove,sports ball,baseball glove	ചുവപ്പും വെള്ളിയും അടയാളം ഉള്ളഏഷ്യൻ പ്രതീകങ്ങൾ
person forces cow to ramble over rocks for unknown reason##person,person,person,tie,person,person,tie,person,cell phone,person	അജ്ഞാതമായ കാരണത്താൽ പശുവിനെ പാറകളിൽ ഇടിക്കാൻ വ്യക്തി നിർബന്ധിക്കുന്നു
The white bins on the second shelf of the fridge.##dog,person,tie,dog	ഫ്രിഡ്ജിലെ രണ്ടാമത്തെ തട്ടിലെ വെളുത്ത കൊട്ടകൾ
a player on second base##mouse,chair,cup,bottle,book,book,book,book,book,book	രണ്ടാമത്തെ അടിത്തറയിലുള്ള കളിക്കാരൻ
air forces flag##person,person,person,person,tennis racket,person,person,person,person,person	വ്യോമസേനയുടെ പതാക
the penalty box is white lined##person,person,person,skis,skis,skis,person	പെനാൽറ്റി ബോക്സ് വെളുത്ത വരയാണ്
yellow plane with characters##person,person,person,baseball glove,person,person,person,baseball bat,tennis racket	പ്രതീകങ്ങളുള്ള മഞ്ഞ തലം
block sneakers with green laces##dog,couch,couch,dog,cat	പച്ച ലെയ്സുകളുള്ള ഷൂ
White copyright stamp##traffic light,person,train,train,person,traffic light,traffic light,traffic light,traffic light,fire hydrant	വെളുത്ത പകർപ്പവകാശ സ്റ്റാമ്പ്
The tennis player's shadow is on the tennis court.##airplane,airplane,truck,person,airplane,person,truck,truck,truck,bus	ടെന്നീസ് കളിക്കാരന്റെ നിഴൽ ടെന്നീസ് കോർട്ടിലാണ്.
case with cross on it also has red trim##fire hydrant,car,person,car,car,traffic light,person,car,truck,person	കുരിശുള്ള ഉള്ള കേസിൽ ചുവന്ന ട്രിം ഉണ്ട്
Two baseball players talking to each other##chair,microwave,dining table	രണ്ട് ബേസ്ബോൾ കളിക്കാർ പരസ്പരം സംസാരിക്കുന്നു
fair large legion of anti-climate change, 350.org, kites with tails in the overcast sky##person,tennis racket,person,person,person,person,bottle,bottle,person,person	കാലാവസ്ഥാ വ്യതിയാനത്തിന്റെ ന്യായമായ വലിയ ലെജിയൻ, മൂന്നൂറ്റി അമ്പത്.ഒർജി, മൂടിക്കെട്ടിയ ആകാശത്ത് വാലുള്ള കൈറ്റ്സ്
white cement block wall##giraffe,giraffe	വെളുത്ത സിമൻറ് ബ്ലോക്ക് മതിൽ
four female soccer players on a grassy field##truck,bench,person	പുൽമേടിൽ നാല് വനിതാ കാല്പന്ത് കളിക്കാർ
models posing on motorcycle##person,bicycle,bicycle,person,bicycle,bicycle,bicycle,bicycle,bicycle,bench	മോട്ടോർ സൈക്കിളിൽ പോസ് ചെയ്യുന്ന മോഡലുകൾ
bird characters on top of a brown cake##person,person,person,car,baseball bat,car,cell phone,car,handbag,truck	ഒരു തവിട്ട് കേക്കിന് മുകളിലുള്ള പക്ഷി പ്രതീകങ്ങൾ
orange time and date stamp##traffic light,car,car,car,car,traffic light,car,car,car,traffic light	ഓറഞ്ച് സമയവും തീയതി സ്റ്റാമ്പും
black mit in players hand##person,refrigerator,cup,cup,dining table,cake,bowl,chair,sink,cell phone	കളിക്കാരുടെ കൈയിൽ കറുത്ത മിറ്റ്
girl showing cow at fair##cat,person,bicycle,bicycle,bicycle,bicycle,backpack,sheep	പെൺകുട്ടി പശുവിനെ മേളയിൽ കാണിക്കുന്നു
the watermark is a block font##airplane,person,person,airplane	വാട്ടർമാർക്ക് ഒരു ബ്ലോക്ക് ഫോണ്ടാണ്
tennis player on the green colored section of a court##bus,bus,bus,bus,bus,bus,book,person,person,bus	ഒരു കോർട്ടിന്റെ പച്ച നിറത്തിലുള്ള വിഭാഗത്തിൽ ടെന്നീസ് കളിക്കാരൻ
the chinese characters on the vase##motorcycle,person	പൂത്തട്ടത്തിലെ ചൈനീസ് പ്രതീകങ്ങൾ
chinese characters are in the sign##person,tennis racket,person,tennis racket,sports ball	ചൈനീസ് പ്രതീകങ്ങൾ അടയാളത്തിലാണ്
fine thin red hair##person,person,person,baseball glove,baseball bat,person,person,person,chair,person	നേർത്ത ചുവന്ന മുടി
Yellow ball on the court.##mouse,book,book,book,book,book,book,book,book,book	കോർട്ടിൽ മഞ്ഞ പന്ത്.
a team of good soccor players.##bed	നല്ല സോക്കർ കളിക്കാരുടെ ഒരു ടീം.
yellow date and time stamp##person,person,person,person,person,person,person,person,person,person	മഞ്ഞ തീയതിയും സമയ സ്റ്റാമ്പും
A postage stamp.##person,person,tennis racket,tennis racket,person,person,sports ball,sports ball,tennis racket,tennis racket	ഒരു തപാൽ സ്റ്റാമ്പ്.
The light forms a rainbow##bed,vase,clock,clock	ആ വെളിച്ചം ഒരു മഴവില്ലായി മാറുന്നു
surfer stand a surfboard##remote,person,book	സർഫർ ഒരു സർഫ്ബോർഡിൽ നിൽക്കുന്നു
english breakfast tea text##person,tennis racket,sports ball	ഇംഗ്ലീഷ് പ്രഭാതഭക്ഷണ ചായ വാചകം
a hard true tennis court##person,teddy bear,teddy bear,book	ഹാർഡ് ട്രൂ ടെന്നീസ് കോർട്ട്
Buttons for pedestrians to cross the street##train	കാൽനടയാത്രക്കാർക്ക് തെരുവ് മുറിച്ചുകടക്കുന്നതിനുള്ള ബട്ടണുകൾ
box springs on bottom of bed##person,skateboard,skateboard,potted plant	കിടക്കയുടെ അടിയിൽ ബോക്സ് സ്പ്രിങ്ങുകൾ
The picture has a date stamp##car,car,car,person,traffic light,person,car,person,person,person	ചിത്രത്തിന് ഒരു തീയതി സ്റ്റാമ്പ് ഉണ്ട്
a train stop block##horse,horse,horse	ഒരു ട്രെയിൻ നിർത്തുന്ന ബ്ലോക്ക്
the springs are silver##motorcycle,motorcycle,car,person,car,person,car,car,motorcycle,car	സ്പ്രിങ്ങുകൾ വെള്ളിയാണ്
orange line on court##person,person,person,person,person,person,person,traffic light,traffic light,kite	കോർട്ടിൽ ഓറഞ്ച് ലൈൻ
a iron stand on back##person,person,person,baseball bat,baseball glove,person,person,person,frisbee,person	പുറകിൽ ഒരു ഇരുമ്പ് സ്റ്റാൻഡ്
green shrubbery that forms a circle around the pedestal##person,person,tie,person,person,person,tie,person,person,tie	പച്ച കുറ്റിച്ചെടി, അത് പീഠത്തിന് ചുറ്റും വൃ ത്താകൃതിയിൽ നിൽക്കുന്നു.
A white box with a red cross.##person,surfboard,surfboard	ചുവന്ന കുരിശുള്ള ഒരു വെളുത്ത പെട്ടി.
a triangle forms on brick##person,person,cell phone,potted plant,potted plant	ഇഷ്ടികയിലെ ഒരു ത്രികോണ രൂപം
fast food##person,person,umbrella,person,person,person,umbrella,person,backpack,umbrella	ഫാസ്റ്റ് ഫുഡ്
person has a stamp on her hand##motorcycle,person,person,person,person,person,person,person,person,person	വ്യക്തിയുടെ കൈയിൽ ഒരു സ്റ്റാമ്പ് ഉണ്ട്
Photo date stamp##person,person,person,person,person,person,person,person,bench,person	ഫോട്ടോയുടെ തീയതി സ്റ്റാമ്പ്
snow on the trees at a cross-country ski race##person,person,person,skis,truck,suitcase,cell phone	ഒരു ക്രോസ്-കൺട്രി സ്കൈ മൽസരത്തിൽ മരങ്ങളിൽ മഞ്ഞ്
little girl standing on a tennis court##	ഒരു ചെറിയ പെൺകുട്ടി ടെന്നീസ് കോർട്ടിൽ നിൽക്കുന്നു
woman sitting on a stone block##sandwich,dining table,chair,bowl,knife	ഒരു കല്ലിൽ ഇരിക്കുന്ന സ്ത്രീ
four men on court##person,person,person,person,person,baseball bat,bench	മൈതാനത്തു നാലുപേര്
postage stamp with liberty bell##person,bus,person,bicycle,person,person,person,person,person,person	സ്വാതന്ത്ര്യമണി ഉള്ള തപാൽ സ്റ്റാമ്പ്
The block for the post##person,tennis racket,sports ball,person,person,person,person,chair	പോസ്റ്റിനായുള്ള ബ്ലോക്ക്
yellow tennis balls on court##motorcycle,potted plant,motorcycle	കോർട്ടിലെ മഞ്ഞ ടെന്നീസ് പന്തുകൾ
the players hanging out in the dugout##bed	ഡഗ് ഔട്ടിൽ ഇരിക്കുന്ന കളിക്കാർ
a man sitting cross legged in the grass##person,person,sports ball,chair,tennis racket	പുല്ലിൽ ചമ്രം പടഞ്ഞിരിക്കുന്ന ആൾ
advertisement on tennis court##bus,bus,car,bus,car,person,car,car,bus,bus	ടെന്നീസ് കോർട്ടിൽ പരസ്യം
White marking on the court##train,train,handbag	കോർട്ടിലെ വെളുത്ത അടയാളം
four shadowy forms of giraffes seemingly looking forward##horse,horse,horse,cow,person	മുന്നിലേക്ക് നീങ്ങുന്ന ജിറാഫുകളുടെ നിഴൽ നിറഞ്ഞ നാല് രൂപങ്ങൾ
date and hotel that the photo was taken##horse,horse,horse,horse,person,horse,horse,person,person,person	ഫോട്ടോ എടുത്ത തീയതിയും ഹോട്ടലും
front springs of motocross motorcycle##cat,book,book,bowl,book	മോട്ടോക്രോസ്സ് മോട്ടോർസൈക്കിളിന്റെ മുൻപിലുള്ള സ്പ്രിങ്ങുകൾ
bat stand in middle of bats##giraffe,giraffe	ബാറ്റ്സ് നടുവിൽ ഉള്ള ബാറ്റ് സ്റ്റാൻഡ്
there is a building behind the court##scissors,bottle,knife,dining table,knife,remote,book	കോർട്ടിന് പിന്നിൽ ഒരു കെട്ടിടമുണ്ട്
bed pillow with cartoon characters on it##person,person,person,baseball glove,baseball glove,skis	ബെഡ് തലയിണയിൽ കാർട്ടൂൺ പ്രതീകങ്ങൾ
food on english muffin with yellow sauce##person,person,baseball glove,person,baseball glove,person,chair,person,person,person	മഞ്ഞ സോസ് ഉപയോഗിച്ച് ഇംഗ്ലീഷ് മഫിനിലെ ഭക്ഷണം
a bench along a tennis court##teddy bear,person,bed,person,person	ഒരു ടെന്നീസ് കോർട്ടിലെ ഒരു ബെഞ്ച്
Baseball cap to block sun##tv,couch,chair,potted plant,potted plant,chair,chair,vase,potted plant,keyboard	സൂര്യനെ തടയാനുള്ള ബേസ്ബോൾ തൊപ്പി
a golden stand for the tub##person,umbrella	സ്നാനതൊട്ടിക്കായി സ്വർണ്ണ നിറത്തിലുള്ള ഒരു സ്റ്റാൻഡ്
area next to pot stand##horse,horse,person,motorcycle,person,person,person,person,person,person	പോട്ട് സ്റ്റാൻഡിന് അടുത്തുള്ള പ്രദേശം
Three baseball players wearing white uniforms are in the background.##microwave,refrigerator,oven,knife,person,person,person,person,person,person	വെളുത്ത യൂണിഫോം ധരിച്ച മൂന്ന് ബേസ്ബോൾ കളിക്കാർ പശ്ചാത്തലത്തിൽ
The players shoes are black.##person,tv,chair,laptop,chair,person,tv,laptop	കളിക്കാരന്റെ ഷൂസ് കറുത്തതാണ്.
fine whiskers on animal's chin##person,person,banana,banana,person,apple,apple,person,banana,banana	മനോഹരമായ താടിരോമം
two horses stand on hill##train,train	രണ്ട് കുതിരകൾ കുന്നിൻ മുകളിൽ നിൽക്കുന്നു
chair is decorated with Disney characters##person,chair,chair,umbrella,chair,chair,chair,chair,chair,chair	കസേര ഡിസ്നി പ്രതീകങ്ങളാൽ അലങ്കരിച്ചിരിക്കുന്നു
the date is orange##person,person,cell phone,book,dining table	തീയതി ഓറഞ്ച് നിറത്തിൽ ആണ്
batter being poured into a waffle press##person,dog,boat,boat,chair,boat,car,truck,chair,airplane	മാവ് കേക്കിന്റെ അച്ചിലേക്ക് ഒഴിക്കുക
This could be at a science fair.##person,person,person,person,person,person,bench,bench,person,baseball glove	ഇത് ഒരു ശാസ്ത്രമേളയിൽ ആകാം.
fine toothed blade of knife##zebra,car,car,car,car	ഫൈൻ പല്ലുള്ള കത്തിയുടെ ബ്ലേഡ്
Shadow running across a tennis court##zebra,zebra,zebra,sports ball,cow	ഒരു ടെന്നീസ് കോർട്ടിലുടനീളം ഷാഡോ
the blue handle of a french press##person,cell phone,cell phone,cup	ഒരു ഫ്രഞ്ച് അച്ചിന്റെ നീല ഹാൻഡിൽ
A dark wooden cross with a small sign attached##broccoli,carrot,sandwich,dining table,cup,hot dog,donut,sandwich	ഒരു ചെറിയ ചിഹ്നമുള്ള ഇരുണ്ട തടി കുരിശ്
Man trying to block the throwing of a frisbee##elephant,elephant,elephant,bird,bird	ഫ്രിസ്‌ബീ എറിയുന്നത് തടയാൻ ഒരു മനുഷ്യൻ ശ്രമിക്കുന്നു
top of tennis court##potted plant,couch,couch,laptop,vase,dining table	ടെന്നീസ് കോർട്ടിന് മുകളിൽ
The date stamp on the photo.##person,book,book,oven,donut,oven,sink	ഫോട്ടോയിലെ തീയതി സ്റ്റാമ്പ്.
tan letters on the tennis court##person,tennis racket,sports ball,bench,sports ball	ടെന്നീസ് കോർട്ടിലെ ടാൻ അക്ഷരങ്ങൾ
boat forms ripples##person,person,person,frisbee,frisbee,frisbee,person,chair,car	ബോട്ട് അലകൾ ഉണ്ടാക്കുന്നു
a sign in a language that isn't English##person,tie	ഇംഗ്ലീഷ് അല്ലാത്ത ഭാഷയിലെ ഒരു അടയാളം
a round wooden block##dog,fire hydrant,dog,car,motorcycle,person,car,bus,stop sign,car	ഒരു വൃത്താകൃതിയിലുള്ള മരം
A fast boat with people in it##boat,person	ആളുകളുള്ള ഒരു അതിവേഗ ബോട്ട്
White clock face with brown characters##person,cell phone,umbrella,cup,person	തവിട്ട് പ്രതീകങ്ങളുള്ള വെളുത്ത ക്ലോക്ക് മുഖം
blue tennis court with painted white boundary lines##person,tennis racket	വെളള അതിർത്തി വരകളുള്ള നീല ടെന്നീസ് കോർട്ട്
the woman on the court##person,person,person,tennis racket,tennis racket,person,bottle,backpack,bench,sports ball	കോർട്ടിലെ സ്ത്രീ
a white surfboard stand next to yellow one##person,truck,car,car,car,car,car,car,car,car	മഞ്ഞ സർഫ്ബോര്ഡിനു അടുത്തായി ഒരു വെളുത്ത സർഫ്ബോർഡ് നിൽക്കുന്നു
the date of the picture##person,person,refrigerator,dog,book,book,cat,book,book	ചിത്രത്തിന്റെ തീയതി
small models boats on TV##motorcycle,motorcycle,person,car,car,car,motorcycle,car,car,motorcycle	ടിവിയിൽ ചെറിയ ബോട്ടിന്റെ മോഡലുകൾ
man taking pictures of players##train,person,person	മനുഷ്യൻ കളിക്കാരുടെ ചിത്രങ്ങൾ എടുക്കുന്നു
buildings are behind the road block##car,car,car,car,car,car,car,car,car,car	റോഡ് ബ്ലോക്കിന് പിന്നിലാണ് കെട്ടിടങ്ങൾ
small patch of grass beside a tennis court##clock	ഒരു ടെന്നീസ് കോർട്ടിനടുത്തുള്ള ചെറിയ പുല്ലിന്റെ ശകലം
Coolers in front of the players.##person,person,person,person,person,sports ball	കളിക്കാർക്ക് മുന്നിൽ കൂളറുകൾ.
some kind of festival or fair##person,tennis racket,person,person,person,person,bird,person	ഒരുതരം ഉത്സവം അല്ലെങ്കിൽ മേള
Two soccer players##airplane,person,truck	രണ്ട് കാല്പന്ത് കളിക്കാർ
decaying amazing building that looks like something between an aztec and buddhist shrine in the english countryside##person,person,sports ball,person,person,tennis racket,person,person,person,person	ഇംഗ്ലീഷ് നാട്ടിൻപുറത്തെ ഒരു ആസ്‌ടെക് + ബുദ്ധക്ഷേത്രത്തിനിടയിലെ എന്തോ ഒന്ന് പോലെ കാണപ്പെടുന്ന അതിശയകരമായ ഒരു കെട്ടിടം
A blue fine on the surf board.##chair,chair,chair,chair,chair,potted plant,dining table,potted plant,chair,potted plant	സർഫ് ബോർഡിൽ ഒരു നീല ഫൈൻ
a missing cider block opening to the outside##cow,cow,cow,truck,car,car,person,potted plant,person,person	പുറത്തേക്ക് തുറക്കുന്ന ഒരു കാണാതായ സൈഡർ ബ്ലോക്ക്
the date is probably somehow, somewhat primitively digitally conveyed##clock,potted plant	തീയതി ഒരുപക്ഷേ എങ്ങനെയെങ്കിലും, പ്രാഥമികമായി ഡിജിറ്റലായി അറിയിക്കുന്നു
pointing sign in english and chinese##bed,potted plant,vase,book,book,book,bed,vase,book	ഇംഗ്ലീഷിലും ചൈനീസിലും പോയിന്റിംഗ് ചിഹ്നം
The players uniform is white##bottle,bottle,bottle,bottle,bottle,bottle,bottle,bottle,bottle,bottle	കളിക്കാരുടെ യൂണിഫോം വെളുത്തതാണ്
one side is in english##person,person,person,person,person,person,person,person,person,person	ഒരു വശം ഇംഗ്ലീഷിലാണ്
A fence at a tennis court##person,potted plant,book,person,tv,book,person,book,vase,book	ടെന്നീസ് കോർട്ടിന്റെ വേലി
lifeguard stand is blue and white##	ലൈഫ് ഗാർഡ് സ്റ്റാൻഡ് നീലയും വെള്ളയുമാണ്
sign written in english and foreign language##train	ഇംഗ്ലീഷ്, വിദേശ ഭാഷകളിൽ എഴുതിയ ചിഹ്നം
gray color on court##person,tennis racket,sports ball	കോർട്ടിൽ ചാരനിറം
fine brown dirt##person,tie,tie	നേർത്ത തവിട്ട് അഴുക്ക്
round light gray large cement block##airplane,airplane,airplane,airplane,airplane,airplane,airplane	വൃത്താകൃതിയിലുള്ള ഇളം ചാരനിറത്തിലുള്ള വലിയ സിമന്റ് ബ്ലോക്ക്
red hat on baseball players head##person,surfboard	ബേസ്ബോൾ കളിക്കാരുടെ തലയിൽ ചുവന്ന തൊപ്പി
second airplane leaves smoke trail##person,person,person,person,car,person,truck,person,car,person	രണ്ടാമത്തെ വിമാനം പുക പാത ഉണ്ടാക്കുന്നു
date 01/05/2011##truck,person,person,person,person,person,dining table,person,person,umbrella	തീയതി 01/05/2011
A skateboard with asian characters painted on the underside##bed,couch,bed	ചുവടെയുള്ള ഏഷ്യൻ പ്രതീകങ്ങളുള്ള ഒരു സ്കേറ്റ്ബോർഡ്
Baseball catcher watching players##person,person,person,tennis racket	കളിക്കാരെ നോക്കുന്ന ബേസ്ബോൾ ക്യാച്ചർ
Skid foot marks on a tennis court##giraffe,person,giraffe	ഒരു ടെന്നീസ് കോർട്ടിൽ കാൽ തെന്നിയ അടയാളങ്ങൾ ഉണ്ട്
yellow poles by the cross sign##teddy bear,teddy bear,person	ക്രോസ് ചിഹ്നത്തിനു സമീപത്തുളള മഞ്ഞ ധ്രുവങ്ങൾ
The TV and stand in the living room##traffic light,car,person,car,person,person,car,person,person,car	ടിവിയും സ്റ്റാൻഡും സ്വീകരണമുറിയിൽ നിൽക്കുന്നു
The front wheel of the second bus.##car,person,car,car,person,car,handbag,car,car,car	രണ്ടാമത്തെ ബസ്സിന്റെ മുൻ ചക്രം.
tan grey fine sand##sandwich,sandwich,person,bowl,sandwich,chair,sandwich,person	ചാരനിറത്തിലുള്ള നേർത്ത മണൽ
boy sitting cross legged##train	ചമ്രം പടഞ്ഞിരിക്കുന്ന ആൺകുട്ടി
Wall design of people characters.##person,person,person,person,person,person,person,person,person,person	ആളുകളുടെ പ്രതീകങ്ങളുള്ള മതിലിലെ രൂപകൽപ്പന.
Baseball in players right hand##giraffe,giraffe,giraffe,laptop,giraffe,chair	കളിക്കാരന്റെ വലതു കൈയിലെ ബേസ്ബോൾ
the second car in the train##person,person,baseball glove,sports ball,tennis racket,person,sports ball	ട്രെയിനിലെ രണ്ടാമത്തെ കാർ
an english style toilet##person,backpack,skateboard	ഒരു ഇംഗ്ലീഷ് ശൈലിയിലുള്ള ടോയ്‌ലറ്റ്
Two baseball players at the plate##person,book	പ്ലേറ്റിൽ രണ്ട് ബേസ്ബോൾ കളിക്കാർ
The sky is fair.##stop sign	ആകാശം മനോഹരമാണ്.
This open-air stand takes place in Jamaica##person,person,person,person,person,person,person,person,person,person	ഈ ഓപ്പൺ എയർ സ്റ്റാൻഡ് ജമൈക്കയിലാണ് നടക്കുന്നത്
Man playing tennis on purple and green tennis court.##sports ball,person,person,person,person,person,person	പർപ്പിൾ, ഗ്രീൻ ടെന്നീസ് കോർട്ടിൽ മനുഷ്യൻ ടെന്നീസ് കളിക്കുന്നു.
tail of cat forms a C##person,dining table,chair,donut,chair,bus,dining table,chair,sandwich	പൂച്ചയുടെ വാൽ ഒരു സി ഉണ്ടാക്കുന്നു
Two fine drinking glasses##person,person,person,person,person,person,cake,person,dining table,person	രണ്ട് കുടിവെള്ള ഗ്ലാസുകൾ
the second gold horse##train,train,person,person,bus,person,person,person	രണ്ടാമത്തെ സ്വർണ്ണ കുതിര
a few people about to cross the road##car,fire hydrant,potted plant,traffic light,traffic light,traffic light,traffic light,person	റോഡ് മുറിച്ചുകടക്കാൻ പോകുന്ന കുറച്ച് ആളുകൾ
Cell phone is in stand.##chair,person,chair,chair,tv,chair,chair,chair,dining table,chair	സെൽ‌ഫോൺ‌ സ്റ്റാന്റിൽ ഇരിക്കുന്നു
the word front on the sign in the english section##person,person,person,baseball glove,person,baseball bat,person,person,person,person	ഇംഗ്ലീഷ് വിഭാഗത്തിലെ അടയാളത്തിലെ ഫ്രണ്ട് എന്ന വാക്ക്
Grass growing on the grass tennis court.##car,car,car,car,car,car,truck,car,car,bus	ഗ്രാസ് ടെന്നീസ് കോർട്ടിൽ പുല്ല് വളരുന്നു.
green and white concession stand near umbrella##person,person,tennis racket,person,person,person,person,person,person,person	പച്ചയും വെള്ളയും കൺസ്സശൻ സ്റ്റാന്റ് കുടയ്ക്കടുത്ത്
glass top on night stand##person,person,person,person,person,person,person,person,person,person	രാത്രി സ്റ്റാൻഡിലെ ഗ്ലാസ് ടോപ്പ്
spectator seats at a tennis court##toilet,spoon,spoon	ഒരു ടെന്നീസ് കോർട്ടിലെ കാണികളുടെ സീറ്റുകൾ
Chain-link enclosure for tennis court##dining table,hot dog,bowl,donut,bottle	ടെന്നീസ് കോർട്ടിനായുള്ള ചെയിൻ-ലിങ്ക് എൻ‌ക്ലോസർ
english word in green##teddy bear,clock,person,teddy bear,handbag,donut	ഇംഗ്ലീഷ് പദം പച്ചയിൽ
Cluttered night stand##person,person,person,person,person,person,tennis racket,person,person,person	അലങ്കോലപ്പെട്ട രാത്രി സ്റ്റാൻഡ്
edge of a stamp##bench	ഒരു സ്റ്റാമ്പിന്റെ അഗ്രം
the lady appears to be going cross country skiing##person,hot dog	ലേഡി ക്രോസ് കണ്ട്രി സ്കീയിംഗിന് പോകുന്നതായി തോന്നുന്നു
a man standing on court##person,person,skateboard,skateboard,car,car,car	കോർട്ടിൽ നിൽക്കുന്ന ഒരാൾ
red bananas at a fruit stand##suitcase,person,suitcase,person,bus,suitcase,backpack,person,suitcase,person	ഫ്രൂട്ട് സ്റ്റാൻഡിലെ ചുവന്ന വാഴപ്പഴം
a toasted english muffin##person,bowl,bed,chair,donut	ഒരു ടോസ്റ്റഡ് ഇംഗ്ലീഷ് മഫിൻ
The sign that says Alice springs##car,person,traffic light,car,car,car,car,car,person,car	ആ അടയാളം ആലീസ് ഉറവകൾ എന്ന് പറയപ്പെടുന്നു
the second hand of the clock##banana,apple,apple,broccoli,orange,broccoli,orange,orange,dining table,broccoli	ക്ലോക്കിന്റെ സെക്കന്റ്‌ സൂചി
black and white tennis court netting##person,skis,skis	ബ്ലാക്ക് ആൻഡ് വൈറ്റ് ടെന്നീസ് കോർട്ട് നെറ്റിംഗ്
black bicycle seat with supporting springs##horse,person,horse,person,horse,person,stop sign,horse,tie	പിന്തുണയ്ക്കുന്ന സ്പ്രിങ്ങുകൾ ഉള്ള കറുത്ത സൈക്കിൾ സീറ്റ്
The comb is fine toothed.##giraffe,giraffe,giraffe,giraffe	ചീപ്പ് പല്ലുള്ളതാണ്.
red double decker bus with Chinese characters and number 8##person,person,car,sports ball,cup,baseball bat	ചൈനീസ് പ്രതീകങ്ങളും എട്ടാം നമ്പറും ഉള്ള റെഡ് ഡബിൾ ഡെക്കർ ബസ്
players uniform is black and gold##elephant,elephant,elephant,elephant,elephant,elephant,elephant,elephant,elephant	കളിക്കാരുടെ യൂണിഫോം കറുപ്പും സ്വർണ്ണവുമാണ്
facial expression, particularly mouth that says, 'yeah, i'm fine w/ being a corporate drone##train,person,person,bottle,carrot,bottle,train	മുഖഭാവം, പ്രത്യേകിച്ച് വായ പറയുന്നു , 'അതെ, ഞാൻ ഒരു കോർപ്പറേറ്റ് ഡ്രോൺ ആയിരിക്കുന്നു
asian characters in red##person,person,tennis racket,tennis racket	ചുവപ്പ് നിറത്തിലുള്ള ഏഷ്യൻ പ്രതീകങ്ങൾ
Starps on the stand.##person,person,baseball glove,sports ball,baseball glove	സ്റ്റാൻഡിൽ സ്റ്റാർപ്പുകൾ.
two man standing on a tennis court##dog,potted plant,potted plant,potted plant,potted plant,bottle,cup,potted plant	രണ്ടുപേർ ടെന്നീസ് കോർട്ടിൽ നിൽക്കുന്നു
a cross railway sign##car,car,car,car,car,car,car,car,car,person	ഒരു ക്രോസ് റെയിൽ‌വേ ചിഹ്നം
fondant characters on cake##chair,chair,couch,tv,potted plant,bottle,tv,vase,book,vase	കേക്കിലെ ഫോണ്ടന്റ് പ്രതീകങ്ങൾ
a museum containing models of airplanes##boat	വിമാനങ്ങളുടെ മാതൃകകൾ ഉൾക്കൊള്ളുന്ന ഒരു മ്യൂസിയം
blue umbrella pole held fast by sand##person,person,baseball bat,sports ball,baseball bat,sports ball	നീല കുടയുടെ ദണ്ഡ് മണലിൽ നിൽക്കുന്നു
five glass vases on the stand##orange,orange,orange,orange,orange,orange,orange,orange,orange,orange	സ്റ്റാൻഡിൽ അഞ്ച് ഗ്ലാസ് പാത്രങ്ങൾ
Blue section of tennis court##oven,vase,traffic light	ടെന്നീസ് കോർട്ടിന്റെ നീല വിഭാഗം
A black barrier stand.##bed,book,vase,book,book,book,book,book	ഒരു കറുത്ത ബാരിയർ സ്റ്റാൻഡ്.
orange date stamp on photo##car,car,car,fire hydrant,car,car,car	ഫോട്ടോയിലെ ഓറഞ്ച് തീയതി സ്റ്റാമ്പ്
green bench on court##person,chair,chair,tennis racket,chair,person,person,sports ball,person,person	കോർട്ടിൽ ഗ്രീൻ ബെഞ്ച്
Lid of glass cake stand##stop sign,train,train	ഗ്ലാസ് കേക്ക് സ്റ്റാൻഡിന്റെ അടപ്പ്
low grey wall behind players##toilet,toilet	കളിക്കാർക്ക് പിന്നിൽ ചെറിയ ചാരനിറത്തിലുള്ള മതിൽ
orange springs on the bottom of train##boat,person	ട്രെയിനിന്റെ അടിയിൽ ഓറഞ്ച് സ്പ്രിങ്ങുകൾ
Straight fine black hair##bus,traffic light,person,person,person,person,person,person,person,person	നേരായുള കറുത്ത മുടി
this players is shirtless##person,car,skateboard,traffic light,person	ഈ കളിക്കാരൻ ഷർട്ട് ഇട്ടിട്ടില്ല
tan colored brick block wall##elephant,elephant	ടാൻ നിറമുള്ള ഇഷ്ടികയുള്ള ബ്ലോക്ക് മതിൽ
the trees in the tennis court##motorcycle,person,person,person,motorcycle,person,person,frisbee,person,traffic light	ടെന്നീസ് കോർട്ടിലെ മരങ്ങൾ
fence next to players##stop sign,fire hydrant,car	കളിക്കാരുടെ അടുത്തുള്ള വേലി
a sign that forms an X##person,boat,person,person,surfboard,surfboard	ഒരു എക്സ് രൂപപ്പെടുന്ന ഒരു അടയാളം
lots of kick+grab marks on white wall below blurry words of graffiti [likely not in english]##remote,person,remote,person,book,couch,bed,person,person,person	ഗ്രാഫിറ്റിയുടെ മങ്ങിയ വാക്കുകൾക്ക് ചുവടെ വെളുത്ത ചുമരിൽ ധാരാളം കിക്ക് + ഗ്രാഫ് അടയാളങ്ങൾ [മിക്കവാറും ഇംഗ്ലീഷിൽ അല്ലാത്തത്.]
a woman in a fair isle sweater##bench,car	മനോഹരമായ ഐൽ സ്വെറ്റർ ധരിച്ചിരിക്കുന്ന ഒരു സ്ത്രീ
Net separating a tennis##person,person,person,sports ball,person,person,person,person,motorcycle,person	ഒരു ടെന്നീസ് കോർട്ടിനെ വേർതിരിക്കുന്നു നെറ്റ്
Double red doors on second floor##traffic light,person	രണ്ടാം നിലയിലെ ഇരട്ട ചുവന്ന വാതിലുകൾ
Mcdonald's advertisement in a language other than english##vase	ഇംഗ്ലീഷ് ഒഴികെയുള്ള ഭാഷയിൽ മക്ഡൊണാൾഡിന്റെ പരസ്യം
a brown cat is stand##bench,person,person,person,person,person,person,person,person,handbag	ഒരു തവിട്ട് പൂച്ച സ്റ്റാൻഡ് ആണ്
Statue honoring members of the armed forces##umbrella,umbrella,umbrella,person,umbrella,person,umbrella,umbrella,umbrella,umbrella	സായുധ സേനയിലെ അംഗങ്ങളോടുള്ള ബഹുമാന സൂചകമായ പ്രതിമ
a group of ball players practicing##person,tennis racket,sports ball	ഒരു കൂട്ടം ബോൾ കളിക്കാർ പരിശീലിക്കുന്നു
This person is waiting to cross the street##person,tennis racket,person,car,car,bench	ഈ വ്യക്തി തെരുവ് മുറിച്ചുകടക്കാൻ കാത്തിരിക്കുകയാണ്
knife set in a wooden block##person,tie,book,book,book,book,book,book,book,book	ഒരു വുഡൻ ബ്ലോക്കിലെ കത്തികളുടെ കൂട്ടം
players shoes are black, red, and white##person,person,person,car,truck,handbag,traffic light,person,person,person	കളിക്കാരുടെ ഷൂസ് കറുപ്പ്, ചുവപ്പ്, വെള്ള എന്നിവയാണ്
long fine whiskers on a cat##person,person,oven,oven,bowl,cup,cup,cup,bowl,book	പൂച്ചയുടെ നീളമുള്ള നേർത്ത രോമങ്ങൾ
Man skiing fast##stop sign,car,car,truck	വേഗത്തിൽ സ്കീയിംഗ് ചെയ്യുന്ന മനുഷ്യൻ
colored springs on truck##broccoli,broccoli,broccoli,broccoli,broccoli,broccoli,broccoli,broccoli,broccoli,broccoli	ട്രക്കിലെ നിറമുള്ള യന്ത്ര സ്പ്രിംഗ്‌
large cement block##person,baseball bat,person,person,person,person,person,person,person,person	വലിയ സിമൻറ് ബ്ലോക്ക്
The tv stand is made of wood##person,person,person,person,person,umbrella,person,person,person,person	ടിവി സ്റ്റാൻഡ് മരം കൊണ്ടാണ് നിർമ്മിച്ചിരിക്കുന്നത്
second skateboard in picture##person,tennis racket,person,chair,person,chair	ചിത്രത്തിലെ രണ്ടാമത്തെ സ്കേറ്റ്ബോർഡ്
black lamb second from right##person,person,person,frisbee,sports ball,chair,sports ball,chair,chair,chair	കറുത്ത ആട്ടിൻകുട്ടി വലത്ത് നിന്ന് രണ്ടാമത്
Look of concentration on game players face##truck,bus,bus,truck,truck	ഗെയിം കളിക്കാരുടെ മുഖത്തെ ഏകാഗ്രത കാണുക
white marking on tennis court##person,banana,banana,banana,banana,banana,banana,banana,banana,banana	ടെന്നീസ് കോർട്ടിലെ വൈറ്റ് മാർക്കിംഗ്
tennis ball shadow on the court##person,bus,person,person,person,person,car,handbag,person,handbag	കോർട്ടിലെ ടെന്നീസ് ബോൾ ഷാഡോ
paper triangle stand##chair,chair,tv,dining table,couch,dining table,dining table,chair,chair	ത്രികോണ പേപ്പർ നില
Blue square on tennis court##person,person,baseball glove,sports ball	ടെന്നീസ് കോർട്ടിലെ നീല ചതുരം
Cinder block base for fence##person,person,person,sports ball,backpack,chair,backpack	വേലിക്ക് സിൻഡർ ബ്ലോക്ക് ബേസ്
a fence behind the players##refrigerator,person,refrigerator,person,refrigerator,person,person,person,person,person	കളിക്കാർക്ക് പിന്നിൽ ഒരു വേലി
jelly jar on top of a chopping block##mouse,keyboard,mouse,tv,cup,tv,laptop,bottle,person,person	ഒരു ചോപ്പിംഗ് ബ്ലോക്കിന് മുകളിൽ ജെല്ലി പാത്രം
Back of court is green.##person,hot dog,hot dog,hot dog,hot dog,hot dog,hot dog,hot dog,hot dog,hot dog	മൈതാനത്തിന്റെ പിൻഭാഗം പച്ചയാണ്.
many wires criss-cross overhead##bird,person,person,person,person,bird,person,person,person,person	കുരിശ്‌അടയാളത്തിലുള്ള പല വയറുകൾ ഉയരത്തിൽ നിൽക്കുന്നു
People waiting to cross street##person,sports ball,person,person,person,chair,person,person,person,person	തെരുവ് മുറിച്ചുകടക്കാൻ കാത്തിരിക്കുന്ന ആളുകൾ
crumbly english muffin bread##person,horse,person,person,person,person,person,person,person,bottle	ക്രംബിലി ഇംഗ്ലീഷ് മഫിൻ ബ്രെഡ്
tennis court with white stripes##person,chair,chair,chair,couch,clock,chair,potted plant,clock,clock	വെളുത്ത വരകളുള്ള ടെന്നീസ് കോർട്ട്
a daytime picture of a couple cross country skiing##teddy bear,teddy bear,person,potted plant,potted plant,chair,chair,cup,book,dining table	ക്രോസ് കൺട്രി സ്കീയിംഗിങ്ങ് ചെയ്യുന്ന ദമ്പതികളുടെ ഒരു പകൽ ചിത്രം
a white sign with black Asian characters going vertically##boat,person,person,person,boat	വെളുത്ത ചിഹ്നം ഉള്ള കറുത്ത ഏഷ്യൻ പ്രതീകങ്ങൾ കുറുകെ പോകുന്നു
Asian characters written on a sign##person,person,person,person,tennis racket,person,chair,person,person,person	ഒരു ചിഹ്നത്തിൽ എഴുതിയ ഏഷ്യൻ പ്രതീകങ്ങൾ
the blue painted do not cross line on the train platform##person,person,tennis racket,bench,tennis racket	നീല നിറം തീവണ്ടി പ്ലാറ്റഫോംമിൽ വര കടന്നു പോകരുത്
a fine silver pocket watch##person,person,person,truck,surfboard,person,truck	മികച്ച സിൽവർ പോക്കറ്റ് വാച്ച്
Blue scooter kick stand##person,potted plant,tennis racket,potted plant	ബ്ലൂ സ്കൂട്ടർ കിക്ക് സ്റ്റാൻഡ്
marked pedestrian cross walk##fork,cup,knife,carrot,dining table,cake,carrot,cake,knife,cup	അടയാളപ്പെടുത്തിയ കാൽനട ക്രോസ് വാക്ക്
block of green water in front of surfer##person,person,person,baseball glove,bed,person	സർഫറിന് മുന്നിലൂടെ പച്ചവെള്ളത്തിന്റെ ബ്ലോക്ക്
a rounded edged wood block##cow,cow,boat,cow,cow	വൃത്താകൃതിയിലുള്ള മരം ബ്ലോക്ക്
sheep running really fast##person,baseball bat,sports ball	ആടുകൾ വളരെ വേഗത്തിൽ ഓടുന്നു
the necktie has a circle cross motif##bus,person,person	നെക്റ്റിക്ക് ഒരു സർക്കിൾ ക്രോസ് മോട്ടിഫ് ഉണ്ട്
the blue 28 on the back of the players shirt##cake,bird,bird,bird,bird	കളിക്കാരന്റെ ഷർട്ടിന്റെ പുറകിലുള്ള നീല 28
large tennis court##person,person,tennis racket,tennis racket,person,person,person,person,person,person	വലിയ ടെന്നീസ് കോർട്ട്
a celtic cross stone monument##person,person,person,tennis racket,person,person,person,person,person,person	ഒരു കെൽറ്റിക് ക്രോസ് സ്റ്റോൺ സ്മാരകം
A TV stand##person,person,person,person,person,person,person,person,person,person	ഒരു ടിവി സ്റ്റാൻഡ്
this is a blue court##sink,sink,toothbrush,kite	ഇതൊരു നീല കളിസ്ഥലമാണ്
hind leg forms one quadrant##person,skis	പിൻ‌കാലുകൾ‌ ഒരു ക്വാഡ്രൻറ് രൂപപ്പെടുത്തുന്നു
the steeple has a cross on top##person,person,person,person,person,person,person,person,person,person	സ്റ്റീപ്പിളിന് മുകളിൽ ഒരു കുരിശുണ്ട്
baseball players signing autographs##person,person,sports ball,person,person,person,person,backpack,person,backpack	ഓട്ടോഗ്രാഫ് ഒപ്പിടുന്ന ബേസ്ബോൾ കളിക്കാർ
the date says 7-1##cow,cow	തീയതി 7-1 പറയുന്നു
A women skiing fast.##bowl,microwave,bowl,spoon,book,oven,cup,book,toothbrush,book	വേഗത്തിൽ സ്കീയിംഗ് ചെയ്യുന്ന സ്ത്രീ
the players shoes have spikes##person,person,umbrella,motorcycle,person,person,car,person,person,umbrella	കളിക്കാരന്റെ ഷൂസിന് സ്പൈക്കുകളുണ്ട്
2010 date in black##suitcase,dog,person,person,person,suitcase,suitcase,baseball bat,person,suitcase	2010 തീയതി കറുപ്പിൽ
littleyiye photographers stamp##person,person,tennis racket,person,person,person,person,bench,person,person	ലിറ്റിൽയിയി ഫോട്ടോഗ്രാഫർമാർ സ്റ്റാമ്പ്
the sport is cross country##person,person,person,person,baseball glove,person,person,person,person,person	ക്രോസ്സ് കൺട്രി ഒരു കായികമാണ്
A black and brown dog fast asleep on the couch.##clock,stop sign,spoon,traffic light	കറുത്തതും തവിട്ടുനിറമുള്ളതുമായ ഒരു നായ കട്ടിലിൽ വേഗത്തിൽ ഉറങ്ങുന്നു.
silver and black french coffee press on shelf##truck,person,car,handbag,car,truck,car	ഷെൽഫിലെ വെള്ളിയും, കറുപ്പും ഫ്രഞ്ച് കോഫി പ്രസ്സ്
Green grass forms the ground.##person,person,frisbee,person,person,person,person,person,person,car	പച്ച പുല്ല് ഗ്രൗണ്ടിൽ രൂപാന്തരപ്പെടുന്നു
a advertisement for highland springs##person,person,person,person,person,person,person,person,person,person	ഹൈലാൻഡ് സ്പ്രിങ്ങ്സ് പരസ്യം
Red table with fast food above it##person,sports ball,tennis racket	ചുവന്ന മേശയുടെ മുകളിലുള്ള ഫാസ്റ്റ്ഫുഡ്
yellow safety tape at a tennis court##person	ഒരു ടെന്നീസ് കോർട്ടിലെ മഞ്ഞ സുരക്ഷാ ടേപ്പ്
Silver springs on the side of bike.##person,cup,bed,teddy bear,teddy bear,person	ബൈക്കിന്റെ വശത്ത് വെള്ളി നിറത്തിലെ സ്പ്രിംഗ്‌
Three baseball players on baseball field.##person,person,person,person,person,baseball glove,person,person,person,baseball bat	ബേസ്ബോൾ മൈതാനത്ത് മൂന്ന് ബേസ്ബോൾ കളിക്കാർ.
leaves on tennis court##person,person,baseball bat,baseball glove,baseball glove	ടെന്നീസ് കോർട്ടിൽ ഇലകൾ
a skate boarder going fast##motorcycle,potted plant,person,person,motorcycle,motorcycle,motorcycle	ഒരു സ്കേറ്റ് ബോർഡർ വേഗത്തിൽ പോകുന്നു
The night stand is wooden.##umbrella,person,person,bench	നൈറ്റ് സ്റ്റാൻഡ് വുഡൻ ആണ്
Light green tennis court##chair,cup,orange,chair,chair,orange,apple,orange,carrot,donut	ഇളം പച്ച ടെന്നീസ് കോർട്ട്
a mirror on a stand##person,baseball glove,sports ball,person,person,person,person,person,person,person	ഒരു സ്റ്റാന്റിൽ ഒരു കണ്ണാടി
Name and date on the bottom right corner.##person,person,person,person,baseball bat,person,baseball glove,baseball glove,baseball glove,person	ചുവടെ വലത് കോണിലുള്ള പേരും തീയതിയും.
players name on his shirt##person,person,person,vase,handbag,umbrella,sandwich,dining table,sandwich,person	കളിക്കാരുടെ പേര് അവന്റെ ഷർട്ടിൽ
a cross walk across street white pattern##sheep,sheep,couch	റോഡിലെ വെളുത്ത വരയ്ക്ക് കുറുകെ സീബ്ര ക്രോസ്സ് ലൈൻ
4 players on the court##scissors,knife,scissors,scissors,person,knife,knife,knife,cell phone	കോർട്ടിൽ നാല് കളിക്കാർ
the second street light##laptop,person	രണ്ടാമത്തെ തെരുവ് വെളിച്ചം
a group of people watching the baseball players##person,person,baseball glove,baseball glove,person,person,sports ball	ഒരു കൂട്ടം ആളുകൾ ബേസ്ബോൾ കളിക്കാരെ കാണുന്നു
an attraction for a fair##person,horse,umbrella,umbrella	ഒരു മേളയ്ക്കുള്ള ആകർഷണം
a butcher block with knives##person,motorcycle,motorcycle,motorcycle,motorcycle,person,motorcycle,motorcycle,car,person	കത്തികളുള്ള ഒരു കശാപ്പ് ബ്ലോക്ക്
the models perky lips##person,person,person,frisbee,person,person,person,person,person,umbrella	മോഡലിന്റെ പെർകി ചുണ്ടുകൾ
gold religious cross on top of golden ball##bowl,bowl,dining table,bowl,sink,dining table,book,bowl,bowl,chair	സ്വർണ്ണ പന്തിന്റെ മുകളിൽ സ്വർണ്ണ മത കുരിശ്
yellow stand##person,person,person,chair,chair,person,umbrella,tennis racket,backpack,umbrella	മഞ്ഞ തട്ട്
two bicyclists waiting to cross intersection##traffic light	കവല മുറിച്ചുകടക്കാൻ കാത്തിരിക്കുന്ന രണ്ട് സൈക്കിൾ യാത്രക്കാർ
Young woman in grey sweatshirt hoping to block frisbee.##person,person,person,person,sports ball,kite,bottle,bottle	ചാരനിറത്തിലുള്ള സ്‌വറ്റ്ഷർട്ടിലുള്ള യുവതി ഫ്രിസ്‌ബിയെ തടയുമെന്ന് പ്രതീക്ഷിക്കുന്നു.
second level of building##person,person,person,teddy bear,person,person,backpack,backpack,person,person	കെട്ടിടത്തിന്റെ രണ്ടാം നില
Coming fast around the bend##person,person,person,person,person,person,chair,baseball bat,chair,chair	വളവിന് ചുറ്റും വേഗത്തിൽ വരുന്നു
gold Chinese characters on a red flag##motorcycle,potted plant	ചുവന്ന പതാകയിൽ സ്വർണ്ണ ചൈനീസ് പ്രതീകങ്ങൾ
Two female tennis players shaking hands##clock,clock	രണ്ട് വനിതാ ടെന്നീസ് കളിക്കാർ കൈ കുലുക്കുന്നു
young female date wearing a purple rhinestone sleeveless gown##person,person,person,tennis racket,person,person,person,person,person,person	ഒരു പർപ്പിൾ റിൻ‌സ്റ്റോൺ സ്ലീവ്‌ലെസ് ഗൗൺ ധരിച്ച യുവതി
easel stand for painting##horse,horse,horse,horse,person,traffic light,person,person,clock,person	പെയിന്റിംഗിനുള്ള ഈസൽ സ്റ്റാന്റ്
stand full of baseball fans##frisbee,person,person,person,person,car,sports ball,sports ball,car	ബേസ്ബോൾ ആരാധകർ നിറഞ്ഞ സ്റ്റാന്റ്
two motor cycle springs##train,person	രണ്ട് മോട്ടോർ സൈക്കിൾ സ്പ്രിങ്ങുകൾ
Chinese characters on the sign##tv,person,chair,tv,person,chair,chair,chair,person	ചിഹ്നത്തിലെ ചൈനീസ് പ്രതീകങ്ങൾ
the players socks are blue##person,person,baseball glove,bench	കളിക്കാരുടെ സോക്സ് നീലയാണ്
the button to press for the light is below the signal##person,tennis racket	ലൈറ്റ് സിഗ്നലിനായി അമർത്തേണ്ട ബട്ടൺ താഴെയാണ്
a woman walking throw a trade fair##carrot,carrot,sheep,sheep,sheep,sheep,sheep,teddy bear,sheep,bird	വ്യാപാര മേളയിലൂടെ നടക്കുന്ന ഒരു സ്ത്രീ
grey concrete cross by the building##bench	കെട്ടിടത്തിൽ ചാരനിറത്തിലുള്ള കോൺക്രീറ്റ് ക്രോസ്
Yellow time and date stamp##person,baseball glove,sports ball	മഞ്ഞ സമയവും തീയതിയും ഉള്ള സ്റ്റാമ്പും
baseball bat in players hands##car,car,chair,truck	കളിക്കാരുടെ കൈകളിലെ ബേസ്ബോൾ ബാറ്റ്
do not block intersection sign is above the right lane must turn right sign##person,sports ball,person,person,person,person,person,person,person,person	കവല ചിഹ്നം വലത് പാതയ്ക്ക് മുകളിലായി തടയരുത് വലത് ചിഹ്നം തിരിക്കണം
Dresser with dinosaur models on top##sheep,sheep,sheep,sports ball,sheep,parking meter,sheep,sheep	മുകളിൽ ദിനോസർ മോഡലുകളുള്ള ഡ്രെസ്സർ
the side of the second train##train	രണ്ടാമത്തെ ട്രെയിനിന്റെ വശം
Man helping child stand on snowboard##person,surfboard	സ്നോബോർഡിൽ നിൽക്കാൻ കുട്ടിയെ സഹായിക്കുന്ന മനുഷ്യൻ
a second statue of a cow##bus,car,person,traffic light,car,person,traffic light,person,person,person	പശുവിന്റെ രണ്ടാമത്തെ പ്രതിമ
Man stand in crane##fire hydrant,book,book	ക്രെയിനിൽ നിൽക്കുന്നു മനുഷ്യൻ
green wall on tennis court##skateboard,person,person,person	ടെന്നീസ് കോർട്ടിന്റെ പച്ച മതിൽ
a man sitting on a cement block##person,baseball glove,person,person,person,person,person,person,person,person	സിമൻറ് ബ്ലോക്കിൽ ഇരിക്കുന്ന ഒരാൾ
players shorts are red##remote,laptop,cup,chair,person,keyboard,dining table,remote,keyboard	കളിക്കാരുടെ ഷോർട്ട്സ് ചുവപ്പാണ്
Man standing on a tennis court##banana,banana,banana,apple,banana,apple,apple,apple,apple,apple	ഒരു ടെന്നീസ് കോർട്ടിൽ നിൽക്കുന്ന മനുഷ്യൻ
The traffic lights stand out a lot.##backpack,person,person,person,bicycle,person,person,person,bus,backpack	ട്രാഫിക് ലൈറ്റുകൾ വളരെയധികം വേറിട്ടുനിൽക്കുന്നു.
green floor next to court##bicycle,person,car,person,person,bus,person,person,truck,person	മൈതാനത്തിന്അടുത്തുള്ള പച്ച തറ
The man's hand forms a fist##person,person,person,apple,bottle,apple,apple,apple,apple,apple	ആ മനുഷ്യൻ മുഷ്ടി ചുരുട്ടി പിടിക്കുന്നു
horse running fast with cowboy on the back##tv,vase,vase,couch,potted plant,potted plant,vase,book,couch,potted plant	കുതിര സവാരിക്കാരനുമായി കുതിര വേഗത്തിൽ ഓടുന്നു
second car attached to train engine##laptop,person,person,person,potted plant,cell phone,person,person,hot dog,hot dog	ട്രെയിൻ എഞ്ചിനിൽ ഘടിപ്പിച്ചിരിക്കുന്ന രണ്ടാമത്തെ കാർ
a red don't cross signal.##chair,tv,couch,couch,chair,chair,remote,chair,dining table,vase	ഒരു ചുവപ്പ് സിഗ്നൽ ക്രോസ് ചെയ്യരുത്.
three black Japanese characters##fork,dining table,laptop,dining table,spoon	മൂന്ന് കറുത്ത ജാപ്പനീസ് പ്രതീകങ്ങൾ
White cross walk in road##person,person,tennis racket,person,tennis racket	റോഡിലെ വൈറ്റ് ക്രോസ് വാക്ക്
mini hi-fi on small stand##airplane	ചെറിയ സ്റ്റാൻഡിലെ മിനി ഹൈ-ഫൈ
car moving incredibly fast##person,person,person,tennis racket,sports ball	അവിശ്വസനീയമാംവിധം വേഗത്തിൽ നീങ്ങുന്നു കാർ
extremely fast bullet train##person,chair,person,person,chair,person,person,person,person,person	വളരെ വേഗതയുള്ള ബുള്ളറ്റ് ട്രെയിൻ
Blue border around tennis court##person,person,person,person,person,person,person,person,person,chair	ടെന്നീസ് കോർട്ടിന് ചുറ്റും നീല അതിർത്തി
a table filled with assorted models and tools##person	വിവിധ തരം മോഡലുകളും ഉപകരണങ്ങളും നിറഞ്ഞ ഒരു ടേബിൾ
A date underneath a clock face##cow,bench	ഒരു ക്ലോക്ക് മുഖത്തിന് ചുവടെയുള്ള തീയതി
group of cross country skiers##person,tennis racket,chair,chair,chair	തുറസ്സായ മഞ്ഞു പ്രതലത്തിലൂടെ തെന്നിപ്പായുന്ന ഒരു കൂട്ടം
several baseball players in the dugout##traffic light	ഡഗൗട്ടിൽ നിരവധി ബേസ്ബോൾ കളിക്കാർ
baseball players dressed in red and gray##person,person,person,person,person,person,person,person,person,chair	ചുവപ്പും ചാരനിറവും ധരിച്ച ബേസ്ബോൾ കളിക്കാർ
The net on a tennis court##stop sign,person,suitcase	ഒരു ടെന്നീസ് കോർട്ടിലെ വല
People with umbrellas waiting to cross the street.##person,laptop,mouse,person,bottle,chair,bird,chair,keyboard,mouse	തെരുവ് മുറിച്ചുകടക്കാൻ കാത്തിരിക്കുന്ന കുടകളുള്ള ആളുകൾ.
A wooden stand##truck,traffic light,train,truck	ഒരു വുഡൻ സ്റ്റാന്റ്
couple guys walking on tennis court##bus,person,person,person,person,bicycle,bicycle,bicycle,bicycle,person	ടെന്നീസ് കോർട്ടിൽ നടക്കുന്ന കപ്പിൾസ്
metal stand for ropes##person,person,person,person,person,tennis racket,person,person,person,person	കയറുകൾക്കുള്ള മെറ്റൽ സ്റ്റാൻഡ്
Big springs on the bottom of train.##person,zebra,car,toilet	ട്രെയിനിന്റെ അടിയിൽ വലിയ സ്പ്രിങ്ങുകൾ .
press type electric cooking grill##person,person,person,person,person,handbag,person,baseball glove,person,person	ഇലക്ട്രിക് പാചക ഗ്രിൽ അച്ച്
dark wooden wash stand##clock,car	ഇരുണ്ട തടി വാഷ് സ്റ്റാൻഡ്
umbrella to block sun##sheep,sheep,sheep	സൂര്യനെ തടയാനുള്ള കുട
teal sign with white asian characters##	വെളുത്ത ഏഷ്യൻ പ്രതീകങ്ങളുള്ള ടീൽ ചിഹ്നം
microphone on angled stand##bed,person,person,person,book,person,book	ആംഗിൾ സ്റ്റാൻഡിലെ മൈക്രോഫോൺ
Bread dough cross hatched design##person,person,person,person,chair,person,person,chair,person,chair	ക്രോസ് ഹാച്ചിട് ഡിസൈൻ ഉള്ള ബ്രെഡിന്റെ മാവ്
soccer players connect chin and forehead##toaster,chair,chair,chair,bottle,knife,dining table,knife,knife,oven	സോക്കർ കളിക്കാർ താടിയും നെറ്റിയും കൂട്ടിമുട്ടിക്കുന്നു
players waiting in dugout##person,person,baseball glove,person,person,person,person,person,person,person	ഡഗഔട്ടിൽ കാത്തിരിക്കുന്ന കളിക്കാർ
tennis players shadow on court##person,skis,skis,backpack,backpack,backpack,backpack,backpack	കോർട്ടിൽ ടെന്നീസ് കളിക്കാരിയുടെ നിഴൽ
a door on the side of the court##clock,person,person,clock,handbag,backpack,traffic light	കോർട്ടിന്റെ വശത്ത് ഒരു വാതിൽ
The players are male.##person,person,frisbee,backpack,truck,truck,car,car,car	കളിക്കാർ പുരുഷന്മാരാണ്.
Baseball team players in the dugout##train,car	ഒറ്റത്തടി വള്ളത്തിൽ ബേസ്ബോൾ ടീം കളിക്കാർ
shadow on tennis court.##giraffe,giraffe,giraffe	ടെന്നീസ് കോർട്ടിൽ നിഴൽ.
date stamp of photo##bus,car,person,person,car,car,person,person,handbag,car	ഫോട്ടോയുടെ തീയതി സ്റ്റാമ്പ്
a wooden block sitting on the table##	മേശപ്പുറത്ത് ഇരിക്കുന്ന ഒരു മരം ബ്ലോക്ക്
a fruit stand with lots of fruits and vegetables##motorcycle,motorcycle	ധാരാളം പഴങ്ങളും പച്ചക്കറികളും ഉള്ള ഒരു ഫ്രൂട്ട് സ്റ്റാൻഡ്
spikes on a players shoe##person,tennis racket	കളിക്കാരുടെ ഷൂവിൽ സ്പൈക്കുകൾ
doilee stand is silver##person,surfboard	ഡോയിലീ സ്റ്റാന്റ് വെള്ളിയാണ്
Three baseball players are in the field.##clock,person	മൂന്ന് ബേസ്ബോൾ കളിക്കാർ കളത്തിലുണ്ട്.
block of white text##person,person,person,person,person,person,person,person,tennis racket,person	വെളുത്ത വാചകത്തിന്റെ ബ്ലോക്ക്
Man sits floor cross legged##person,traffic light,car,car,traffic light,person,traffic light,car,person,car	മനുഷ്യൻ ഫ്ലോറിൽ കാല് ക്രോസ്സ് ചെയ്ത് ഇരിക്കുന്നു
grass tennis court##dog	പുൽ ടെന്നീസ് മൈതാനം
second red and blue train##motorcycle,person,traffic light,traffic light,car,car,car,person,motorcycle,fire hydrant	രണ്ടാമത്തെ ചുവപ്പ്, നീല ട്രെയിൻ
Cather's mit for hand protection against fast pitches.##clock,tv	ഫാസ്റ്റ് പിച്ചുകളിൽ നിന്ന് കൈ സംരക്ഷണത്തിനായി കാതേർസ് മിറ്റ്.
man is waiting to cross##person,person,cell phone	മനുഷ്യൻ കടക്കാൻ കാത്തിരിക്കുന്നു
a time and date stamp##cow,person,baseball bat	ഒരു സമയ, തീയതി സ്റ്റാമ്പ്
people enjoying themselves at the fair##fire hydrant,car,car,car,car,car,car,car,car,car	മേളയിൽ ആളുകൾ സ്വയം ആസ്വദിക്കുന്നു
A sign for the 550 west block of Bliss Ct.##orange,orange,potted plant,oven,dining table,oven,cup,broccoli	ബ്ലിസ് സിടിയുടെ അഞ്ഞൂറ്റി അമ്പത് പടിഞ്ഞാറൻ ബ്ലോക്കിലേക്കുളള ഒരു അടയാളം.
The water is flowing fast##airplane,car	വെള്ളം അതിവേഗത്തിൽ ഒഴുകുന്നു
Watermark, showing copyright date.##umbrella,clock,potted plant,clock,umbrella,potted plant,potted plant,potted plant,clock	വാട്ടർമാർക്ക്, പകർപ്പവകാശ തീയതി കാണിക്കുന്നു.
Part of the tennis court is green.##person,person,baseball bat,person,baseball glove,tie,tie	ടെന്നീസ് കോർട്ടിന്റെ ഭാഗം പച്ചയാണ്.
Green and red tennis court##person,sheep,sheep,umbrella,sheep,dog,teddy bear,person,dog,person	പച്ചയും, ചുവപ്പും ടെന്നീസ് കോർട്ട്
A indoor tennis court.##person	ഇൻഡോർ ടെന്നീസ് കോർട്ട്.
A bed of steel springs##stop sign,stop sign	ഉരുക്ക് സ്പ്രിങ്ങുകൾ ഉള്ള ഒരു കിടക്ക
display models of cell phones##person,person,bicycle,person,bicycle,person,chair,person,person,remote	സെൽ‌ഫോണുകളുടെ മോഡലുകൾ‌ പ്രദർശിപ്പിച്ചിരിക്കുന്നു
a lone spectator behind the tennis players##person,tennis racket,sports ball,person,person,person,person,person,person,person	ടെന്നീസ് കളിക്കാർക്ക് പിന്നിൽ ഒരു കാഴ്ചക്കാരൻ
Cement forms sticking out of ground.##person,person,person,person,person,person,person,person,boat,person	സിമൻറ് രൂപങ്ങൾ നിലത്തു നിന്ന് പുറത്തുകടക്കുന്നു.
A time stamp##person,person,person	ഒരു ടൈം സ്റ്റാമ്പ്
fast food hot dogs and onion rings##person,person,airplane,person,person,person,person,person,person,person	ഫാസ്റ്റ് ഫുഡ് ഹോട്ട് ഡോഗുകളും ഒണിയൻ റിങ്സുo
owners manual for a panini press##person,person,remote,chair,laptop,chair,chair,laptop	പാനിനി പ്രസ്സിനായി ഉടമകളുടെ മാനുവൽ
Asian characters on side of building##bicycle,bench,bench,bottle,boat,bicycle,boat,boat,boat,bottle	കെട്ടിടത്തിന്റെ വശത്തുള്ള ഏഷ്യൻ പ്രതീകങ്ങൾ
an orange sign with written characters##person,tennis racket,sports ball	ഒരു ഓറഞ്ച് ചിഹ്നത്തിൽ എഴുതിയ പ്രതീകങ്ങൾ ഉണ്ട്
truck has two white Chinese characters##person,toilet,person,sink,refrigerator,laptop,cup,person,person	ട്രക്കിന് രണ്ട് വെളുത്ത ചൈനീസ് പ്രതീകങ്ങളുണ്ട്
a copy of vanity fair is displayed##person,person,kite,person,kite,kite,umbrella,person,person,person	വാനിറ്റി മേളയുടെ ഒരു പകർപ്പ് പ്രദർശിച്ചിട്ടുണ്ട്
a baseball players bat##person,person,person,sports ball,bicycle	ഒരു ബേസ്ബോൾ കളിക്കാരൻ ബാറ്റ് ചെയ്യുന്നു
advertising to the state fair is mounted on the lamp post##bird,bird,bird,bird,bird,bird	സംസ്ഥാന മേളയിലേക്കുള്ള പരസ്യം വിളക്ക് പോസ്റ്റിൽ സ്ഥാപിച്ചിരിക്കുന്നു
A stand of trees along the edge of the lake##person,person,person,person,baseball bat,person,person,person,person,person	തടാകത്തിന്റെ അരികിലുള്ള മരങ്ങളുടെ ഒരു കൂട്ടം
The tennis players arm extended.##person,car,person,person,skateboard,dog,car,person,person,car	ടെന്നീസ് കളിക്കാരന്റെ കൈ നീട്ടിയിരിക്കുന്നു.
a hand moving too fast for the camera##person,person,person,person,person,skis,person,person,person,skis	ക്യാമറ വളരെ വേഗത്തിൽ ചലിക്കുന്നു
Four baseball players on field.##remote,keyboard,keyboard,person,keyboard	മൈതാനത്ത് നാല് ബേസ്ബോൾ കളിക്കാർ.
A cross on a tower.##person,tennis racket,sports ball	ഗോപുരത്തിന്റെ മുകളിൽ ഒരു കുരിശ്.
White writing on a blue court.##person,bottle,bottle,cake,oven,bottle,bottle,cake,bottle,bottle	നീല കോർട്ടിൽ വെളുത്ത എഴുത്ത്.
Shadow on the ground of the second racket from the left##person,person,sports ball,person,tennis racket,person,person,person,person,person	ഇടതുവശത്ത് നിന്നുള്ള രണ്ടാമത്തെ റാക്കറ്റിന്റെ നിലത്ത് നിഴൽ
a wood night stand.##person,tennis racket,sports ball	തടി മേശ
Snow covered cross walk##person,surfboard	മഞ്ഞ് മൂടിയ ക്രോസ്സ് വാക്ക്
green grass by tennis court##tv,couch,suitcase,tv,dining table,vase	പച്ച പുല്ല് ഉള്ള ടെന്നീസ് കോർട്ട്
The brick wall behind the court##cow,cow	കോർട്ടിന് പിന്നിലെ ഇഷ്ടിക മതിൽ
a railing forms a corner sitting area##person,person,tennis racket,tennis racket,car	ഒരു റെയിലിംഗ് ഒരു കോണിൽ ഇരിക്കുന്ന സ്ഥലമായി മാറുന്നു
Banana shaped yellow banana stand##bear	വാഴപ്പഴത്തിന്റെ ആകൃതിയിലുള്ള മഞ്ഞ വാഴ സ്റ്റാൻഡ്
Green part of a tennis court.##person,refrigerator,truck,truck	ഒരു ടെന്നീസ് കോർട്ടിന്റെ പച്ച ഭാഗം.
Box springs of bed.##bed,chair,couch,cup	കിടക്കയിലെ ബോക്സ് സ്പ്രിങ്ങ്സ്.
Small section of baseline on a tennis court##truck,truck,person,truck,truck,truck,person	ഒരു ടെന്നീസ് കോർട്ടിലെ ബേസ്‌ലൈനിന്റെ ചെറിയ വിഭാഗം
Large cross outside of a church.##train,traffic light,train,person,train,car,car,traffic light	ഒരു പള്ളിക്ക് പുറത്ത് വലിയ കുരിശ്.
two white chairs on tennis court##person,person,person,baseball bat,person,person,person,baseball glove,person,person	ടെന്നീസ് കോർട്ടിലെ രണ്ട് വെളുത്ത കസേരകൾ
white edge of white tennis court##person,person,person,person,baseball glove,person,person,baseball bat,person,person	വൈറ്റ് ടെന്നീസ് കോർട്ടിന്റെ വെളുത്ത അഗ്രം
Brown box is on the tennis court##chair,refrigerator,bowl,bottle,microwave,bottle	ബ്രൗൺ ബോക്സ് ടെന്നീസ് കോർട്ടിലാണ്
a sponsors name on the tennis court wall##bird	ടെന്നീസ് കോർട്ട് ചുമരിൽ ഒരു സ്പോൺസർ നാമം
the date is shown on the outter portion##motorcycle,person,motorcycle,person,motorcycle,truck,car,car,motorcycle,motorcycle	തീയതി ബാഹ്യ ഭാഗത്ത് കാണിച്ചിരിക്കുന്നു
exte stamp on yellow metal##	മഞ്ഞ ലോഹത്തിൽ എക്സ്റ്റെ സ്റ്റാമ്പ്
Bright red semi-gloss block wall##bus,person,umbrella,person,umbrella,person,person,person,person	തിളക്കമുള്ള ചുവന്ന പകുതി മിനുക്കമുള്ള മതിൽ
Name and date stamp on picture##umbrella,person,person	ചിത്രത്തിലെ പേരും തീയതി സ്റ്റാമ്പും
fine texture of feathers##clock	തൂവലുകളുടെ മികച്ച ഘടന
clock face on wall date##person,person,sports ball,baseball glove	മതിൽ തീയതിയിലെ ക്ലോക്ക് മുഖം
Brown painted signature and date.##person,person,person,person,person,person,person,person,handbag,person	ബ്രൗൺ പെയിന്റിൽ എഴുതിയ ഒപ്പും തീയതിയും.
Neon green time and date stamp##knife,person,carrot,carrot,knife,carrot,dining table	നിയോൺ പച്ച സമയവും തീയതി സ്റ്റാമ്പും
white teeth-like forms on top of wing##person,train,bench,person	ചിറകിന്റെ മുകളിൽ വെളുത്ത പല്ലുകൾ പോലുള്ള രൂപങ്ങൾ
Headpiece of the second rider from the right##keyboard,dining table	വലതുവശത്ത് നിന്നുള്ള രണ്ടാമത്തെ റൈഡറിന്റെ ഹെഡ്‌പീസ്
The items of the second rack##horse,person,dog	രണ്ടാമത്തെ റാക്കിലെ ഇനങ്ങൾ
a cross on the top of a spire##person,sports ball,tennis racket,tennis racket	ഒരു സ്പൈറിന്റെ മുകളിൽ ഉള്ള ഒരു കുരിശ്
the characters are chinese##scissors,toothbrush,scissors,scissors	പ്രതീകങ്ങൾ ചൈനീസ് ആണ്
tree root jutting out in jagged forms##cup,pizza,pizza,broccoli	ട്രീ റൂട്ട് മുല്ലപ്പൂ രൂപത്തിൽ പുറത്തേക്ക് തളളി നില്ക്കുന്നു
bicycles in stand##traffic light,tv	സൈക്കിളുകൾ സ്റ്റാന്റിൽ
second floor windows##	രണ്ടാം നിലയിലെ വിൻഡോകൾ
there are two players in the court##person,cow,baseball glove,cow	കോർട്ടിൽ രണ്ട് കളിക്കാരുണ്ട്
Partial view of second bus##bird,bird,person,person,car,car	രണ്ടാമത്തെ ബസിന്റെ ഭാഗിക കാഴ്ച
Chinese characters on sign##person,person,person,person,clock,person,person,person,person,tennis racket	ചിഹ്നത്തിലുള്ള ചൈനീസ് പ്രതീകങ്ങൾ
large soft drink cup from a fast food restaurant or store##person	ഒരു ഫാസ്റ്റ്ഫുഡ് റെസ്റ്റോറന്റിൽ നിന്നോ സ്റ്റോറിൽ നിന്നോ ഉള്ള വലിയ ശീതള പാനപാത്രം
Baseball players are in the background##refrigerator,bench,suitcase,chair	ബേസ്ബോൾ കളിക്കാർ ബാക്ക് ഗൗണ്ടിൽ ഉണ്ട്
rolls of towels on stand##suitcase,chair,clock,bed,person	തൂവാലകളുടെ റോളുകൾ സ്റ്റാന്റിൽ
a cement block wall##person,person,person,person,person,person,baseball bat,baseball bat,person,person	ഒരു സിമന്റ് ബ്ലോക്ക് മതിൽ
People waiting to cross street.##teddy bear,cake,person,person,person,dining table	തെരുവ് മുറിച്ചുകടക്കാൻ കാത്തിരിക്കുന്ന ആളുകൾ.
Mud forms along the edge of the watering hole##person,wine glass,person,spoon,spoon,knife,dining table,chair,chair,spoon	നനവ് ദ്വാരത്തിന്റെ അരികിൽ ചെളി രൂപം കൊള്ളുന്നു
bananas and oranges on fruit stand##person,person,person,baseball glove	ഫ്രൂട്ട് സ്റ്റാൻഡിൽ വാഴപ്പഴവും ഓറഞ്ചും
Cows laying down in the hay at a county fair##traffic light,car,traffic light,traffic light	ഒരു കൗണ്ടി മേളയിൽ പശുക്കൾ പുല്ലിൽ കിടക്കുന്നു
players standing behind chain link fence##person,person,person,person,person,person,person,person,person,person	ചെയിൻ ലിങ്ക് വേലിക്ക് പിന്നിൽ നിൽക്കുന്ന കളിക്കാർ
Knives in wood block##keyboard,tv,book,book	തടിക്കഷണത്തിൽ കത്തികൾ
College baseball players on the field.##keyboard,chair,tv,mouse,tv,cup,book,book,book,book	മൈതാനത്ത് കോളേജ് ബേസ്ബോൾ കളിക്കാർ.
The blue tennis court##person,tennis racket	നീല ടെന്നീസ് കോർട്ട്
poster with cartoon characters##person,sports ball,tennis racket	കാർട്ടൂൺ പ്രതീകങ്ങളുള്ള പോസ്റ്റർ
boundary lines on court##banana,person,banana,banana	കോർട്ടിലെ അതിർത്തി രേഖകൾ
a church tower with a cross on the roof##train,bus,person,bird	മേൽക്കൂരയിൽ കുരിശുള്ള പള്ളി ഗോപുരം
a photographers stamp on the photo##bird,person,clock	ഒരു ഫോട്ടോയിലെ ഫോട്ടോഗ്രാഫറുടെ സ്റ്റാമ്പ്
a bunch of baseball players waiting for their turn##person,skis	ഒരു കൂട്ടം ബേസ്ബോൾ കളിക്കാർ അവരുടെ അവസരത്തിനായി കാത്തിരിക്കുന്നു
time stamp with red number##bus,person,person,car,person,person,person,person,person,person	ചുവന്ന നമ്പറുള്ള ടൈം സ്റ്റാമ്പ്
orange street block##train,train,train,train,train,train,person,car,train,car	ഓറഞ്ച് സ്ട്രീറ്റ് ബ്ലോക്ക്
picture taken at drive up fast food chain##tv,cat,couch,couch,bowl	ഡ്രൈവ് അപ്പ് ഫാസ്റ്റ്ഫുഡ് ചെയിനിൽ എടുത്ത ചിത്രം
foul lines marking the court##bus	കളിസ്ഥലത്തു അടയാളപ്പെടുത്തിയ തെറ്റായ വരികൾ
second green sign from the top##sink,traffic light,toilet,bottle,traffic light,sink,toilet,cup,bottle,cake	മുകളിൽ നിന്ന് രണ്ടാമത്തെ പച്ച ചിഹ്നം
second leaf from left##person,person,kite,kite,person,person,person,person,person,kite	ഇടത് വശത്ത് നിന്ന് രണ്ടാമത്തെ ഇല
the picture has a date stamp##cup,person,bowl,bottle,spoon,dining table,dining table,potted plant	ചിത്രത്തിന് ഒരു തീയതി സ്റ്റാമ്പ് ഉണ്ട്
the tennis court net divides the court in the middle##person,person,knife,knife,bowl,bottle,oven,oven,oven,bottle	ടെന്നീസ് കോർട്ട് നെറ്റ് കോർട്ടിനെ മധ്യഭാഗത്ത് വിഭജിക്കുന്നു
this stand is yellow in color##toilet	ഈ സ്റ്റാന്റ് മഞ്ഞ നിറത്തിലാണ്
Soccer players on field.##person,person,chair,chair,dining table,chair,dining table,microwave,chair,bottle	മൈതാനത്ത് സംഘ പന്തുകളിക്കാർ.
players in team dugout##person,suitcase,book,cat,book,book,chair,chair,bed,bed	ഡഗ്ഔട്ടിൽ കളിക്കാർ
different plane models are seen.##person,person,person,person,person,person,tennis racket,chair,person,chair	വ്യത്യസ്ത തരം മോഡലുകൾ കാണാം.
baseball players on field##elephant,zebra,zebra,zebra,zebra,zebra,zebra,zebra,zebra,zebra	മൈതാനത്ത് ബേസ്ബോൾ കളിക്കാർ
a red and white county fair tent##fork,orange,cake,cup,sandwich,dining table,cake,cup	ചുവപ്പും വെള്ളയും ഉള്ള കൗണ്ടി മേള കൂടാരം
time stamp in corner of image##person,chair,person,person,person,person,person,person,person,person	ചിത്രത്തിന്റെ മൂലയിൽ ടൈം സ്റ്റാമ്പ്
green colored material separating the court##motorcycle	മൈതാനത്തെ വേർതിരിക്കുന്ന പച്ച നിറമുള്ള മെറ്റീരിയൽ
farmer's market stand##person,tennis racket,sports ball	കർഷകന്റെ വിപണി സ്റ്റാന്റ്
a tree on a city block##person,potted plant,couch,knife	സിറ്റി ബ്ലോക്കിലെ ഒരു മരം
aqua press wall with white advertising signs##person,person,person,person,person,bench,person,person,person,bench	വെളുത്ത പരസ്യ ചിഹ്നങ്ങളുള്ള അക്വാ പ്രസ്സ് മതിൽ
man using a hand press to make juice##umbrella,umbrella,umbrella,umbrella,umbrella,umbrella,umbrella,umbrella,umbrella,umbrella	ജ്യൂസ് ഉണ്ടാക്കാൻ ഹാൻഡ് പ്രസ്സ് ഉപയോഗിക്കുന്ന മനുഷ്യൻ
the train is a fast speed train##person,couch,cell phone	ട്രെയിൻ അതിവേഗ ട്രെയിനാണ്
Two characters on the television##person,book,remote,book,book,book,book,book,book,book	ടെലിവിഷനിൽ രണ്ട് കഥാപാത്രങ്ങൾ
men of forces wearing the dress uniforms##person,traffic light,traffic light,tv	യൂണിഫോം ധരിച്ച സേനാംഗങ്ങൾ
red second hand on top of other hands##person,bottle,person,baseball bat,person,baseball bat,person,person,baseball bat,baseball bat	മറ്റ് സൂചികളുടെ മുകളിലാണ് ചുവന്ന സെക്കന്റ്‌ സൂചി
a cats closed eye forms a slit##cake,cake,cake,cake,cake,cake,cake,cake,cake,cake	പൂച്ച അടച്ച കണ്ണ് ഒരു വിടവ് ഉണ്ടാക്കുന്നു
the two male players are after the ball##person,person,person,tennis racket,person,person,person,person,person,person	രണ്ട് പുരുഷ കളിക്കാർ പന്തിന് പുറകേയാണ്
Glass safety rail on second floor.##airplane,airplane,airplane,airplane,airplane,airplane,airplane,airplane,person,airplane	രണ്ടാം നിലയിലെ ഗ്ലാസ് സുരക്ഷാ റെയിൽ.
Soccer players in action##person,toothbrush	സോക്കർ കളിക്കുന്ന കളിക്കാർ
a book is on the night stand##refrigerator,oven,microwave,knife,knife,knife,knife,knife,knife,knife	രാത്രി സ്റ്റാൻഡിൽ ഒരു പുസ്തകം ഉണ്ട്
Black bike seat with silver springs.##tv,person,bottle,book,book,book,book,book,book,book	വെള്ളി സ്പ്രിങ്ങുകൾ ഉള്ള കറുത്ത ബൈക്ക് സീറ്റ്.
a baseball players uniform##pizza,person,cup,wine glass,dining table,cup,bottle,dining table	ഒരു ബേസ്ബോൾ കളിക്കാരന്റെ യൂണിഫോം
the seat of the second motorcycle##bird,bird,bird	രണ്ടാമത്തെ മോട്ടോർസൈക്കിളിന്റെ സീറ്റ്
pattern on side of second giraffe##person,clock,person,fire hydrant,car,person,car,car,car,car	രണ്ടാമത്തെ ജിറാഫിന്റെ വശത്തുള്ള പാറ്റേൺ
A red metal frame forms the half pipe##person,motorcycle	ഒരു ചുവന്ന മെറ്റൽ ഫ്രെയിം പകുതി പൈപ്പ് ഉണ്ടാക്കുന്നു
fast blue and white train##person,tv,remote,bottle,chair,suitcase,book,book,couch,chair	വേഗത്തിലുള്ള നീലയും വെള്ളയും ട്രെയിൻ
red second hand##bird,bicycle,surfboard	ചുവന്ന സെക്കൻഡ് ഹാൻഡ്
red on players sleeve##sink,refrigerator,bowl,chair	കളിക്കാരുടെ സ്ലീവിൽ ചുവപ്പ്
Luggage sign in english and spanish##person,sports ball,tennis racket,person,person,person	ലഗ്ഗേജ് ചിഹ്നം ഇംഗ്ലീഷിലും സ്പാനിഷിലും
net of the tennis court##suitcase,suitcase,suitcase,suitcase,suitcase,suitcase,suitcase,vase,suitcase	ടെന്നീസ് കോർട്ടിലെ വല
The tracks cross here##train,train	ട്രാക്കുകൾ ഇവിടെ കടക്കുന്നു
Blue, yellow and white stripes on players uniform.##oven,microwave,refrigerator,chair,cup,cup,cup,vase	കളിക്കാരുടെ യൂണിഫോമിൽ നീല, മഞ്ഞ, വെള്ള വരകൾ.
the net across their court##person,person,person,person,person,person,person,person,person,person	അവരുടെ കോർട്ടിന് കുറുകെ ഉള്ള വല
part of a tennis court##truck,person	ഒരു ടെന്നീസ് കോർട്ടിന്റെ ഭാഗം
the copyright and date stamp of the photographer##person,person,hot dog,person,person	ഫോട്ടോഗ്രാഫറുടെ പകർപ്പവകാശവും തീയതി സ്റ്റാമ്പും
fast food items on plates##cat,refrigerator,book,cup,book,toothbrush,book	പ്ലേറ്റുകളിലെ ഫാസ്റ്റ്ഫുഡ് ഇനങ്ങൾ
member of opposing team trying to block the shooter's shot##fork,person,sandwich,dining table,sandwich,hot dog,knife,knife,dining table,knife	ഷൂട്ടറുടെ ഷോട്ട് തടയാൻ ശ്രമിക്കുന്ന എതിർ ടീമിലെ അംഗം
white trail that can only be made by incredibly fast planes##person,person,person,person,person,person,person,person,person,car	അവിശ്വസനീയമാംവിധം വേഗത്തിലുള്ള വിമാനങ്ങൾക്ക് മാത്രമേ വെള്ള വര നിർമ്മിക്കാൻ കഴിയൂ
Monitor stand below monitor##person,sheep,person,sheep,person,sheep,person,sheep,sheep,sheep	മോണിറ്ററിന് താഴെയുള്ള മോണിറ്റർ സ്റ്റാന്റ്
Red circle with white cross under right wing##person,tennis racket,person,person,person,person,tennis racket,sports ball,tennis racket	വലത് ചിറകിന് താഴെ വെളുത്ത കുരിശുള്ള ചുവന്ന വൃത്തം
tennis players shaking hands##person,bird,frisbee,clock,car,dining table,bench,bench	ടെന്നീസ് കളിക്കാർ കൈ കുലുക്കുന്നു
Time date stamp is bottom right##chair,chair,chair,potted plant,couch,chair,vase,chair,couch,chair	സമയ തീയതി സ്റ്റാമ്പിന്റെ താഴെ വലതുവശത്താണ്
the players uniform is green and white##person,person,person,person,person,person,kite,person,kite,person	കളിക്കാരന്റെ യൂണിഫോം പച്ചയും വെള്ളയുമാണ്
Tarp on the side of the court##keyboard,laptop,keyboard,keyboard	കോർട്ടിന്റെ വശത്ത് ടാർപ്പ
a man in a yellow t-shirt sitting cross-legged##person,airplane,person,person	മഞ്ഞ ടി-ഷർട്ട് ധരിച്ച ഒരാൾ കാല് ക്രോസ്സ് ചെയ്ത് ഇരിക്കുന്നു
long black pipe on display stand##chair,potted plant,chair,couch,couch,potted plant,wine glass,chair	ഡിസ്പ്ലേ സ്റ്റാൻഡിലെ നീളമുള്ള കറുത്ത പൈപ്പ്
cement block siding on church##person,person,person,backpack,skis,snowboard,backpack,skis,backpack	പള്ളിയിൽ സിമന്റ് ബ്ലോക്ക് സൈഡിംഗ്
fine, pale sand##cell phone,cell phone,dining table,chair,bowl,chair,chair,cell phone,person,dining table	നേർത്ത, ഇളം മണൽ
propeller is moving fast##	പ്രൊപ്പല്ലർ അതിവേഗം നീങ്ങുന്നു
players wearing knee-high socks##person,tennis racket	ക്‌നീ ഹൈ സോക്സ് ധരിച്ച കളിക്കാർ
second bird is standing on car##person,skateboard,person	രണ്ടാമത്തെ പക്ഷി കാറിൽ നിൽക്കുന്നു
clear stand for controller##person,person,tennis racket,sports ball,sports ball,sports ball,tennis racket,sports ball,sports ball,sports ball	കൺട്രോളറിനുള്ള വ്യക്തമായ സ്റ്റാന്റ്
date and time stamp in corner##bench,potted plant,bench,bench,bench,bench,bench,bench,bench,bench	കോണിലുള്ള തീയതിയും സമയ സ്റ്റാമ്പും
Woman going fast downhill.##bottle,chair,knife,bottle,chair,chair,knife,bowl,bottle,dining table	വേഗത്തിൽ താഴേക്ക് പോകുന്ന സ്ത്രീ.
baseball players shoe##person,person,person,person,tennis racket,person,person,person,person,person	ബേസ്ബോൾ കളിക്കാരന്റെ ഷൂ
the collar decoration of a fair isle type sweater##person,dog,person,surfboard,surfboard	നല്ല ഐസ്ൽ തരം സ്വെറ്ററിന്റെ കോളർ ഡെക്കറേഷൻ
a juice press##car	ഒരു ജ്യൂസ് പ്രസ്സ്
little white english car with vertical oblong taillights##baseball bat,baseball bat	ലംബമായ ദീർഘചതുരത്തിൽ പിൻദീപമുള്ള ചെറിയ വെളുത്ത നിരത്തിലെ ഇംഗ്ലീഷ് കാർ
male cross country skier##person,person,person,person,person,person,person,person,person,bench	പുരുഷ ക്രോസ് കൺട്രി സ്കയർ
press here sticker on paw##motorcycle,motorcycle,person,person,person,motorcycle,person,person,umbrella,umbrella	കൈയിൽ പ്രസ്സ് ഹിയർ സ്റ്റിക്കർ
a green tennis court##person,tennis racket,sports ball	ഒരു പച്ച ടെന്നീസ് കോർട്ട്
Base of the yellow umbrella second from the left##person,person,bottle,tennis racket,person,person,person,tennis racket,tennis racket,person	ഇടത് വശത്ത് നിന്ന് മഞ്ഞ കുടയുടെ അടിസ്ഥാനം
white asphalt with fine lines##horse,horse,person,person,dog,horse,person	നേർത്ത വരകളുള്ള വെളുത്ത അസ്ഫാൽറ്റ്
loose sediment forms on the rocks##clock,person,car	പാറകളിൽ അയഞ്ഞ അവശിഷ്ട രൂപങ്ങൾ
wooden slat that forms back of bench.##person,baseball glove	ഒരു വുഡൻ സ്ലാറ്റ് ബെഞ്ചിന്റെ പുറകിൽ രൂപം കൊള്ളുന്നു.
fast super jet hovers in the sky##person,person,car,car,car,person,car,person,car,car	ഫാസ്റ്റ് സൂപ്പർ ജെറ്റ് ആകാശത്ത് സഞ്ചരിക്കുന്നു
People buying food on fast food store##person,sports ball,person,person,person,person,person,person,person,person	ഫാസ്റ്റ്ഫുഡ് സ്റ്റോറിൽ ഭക്ഷണം വാങ്ങുന്ന ആളുകൾ
geyer springs street sign##clock,fork,scissors	ഗിയർ സ്പ്രിംഗ്സ് സ്ട്രീറ്റ് ചിഹ്നം
copyright and date##person,tennis racket,sports ball,baseball bat,sports ball,sports ball,sports ball,sports ball,sports ball	പകർപ്പവകാശവും തീയതിയും
the players arm is ready to throw##car,person,person,person,person,train,person,person,person,person	കളിക്കാരുടെ കൈ എറിയാൻ തയ്യാറാണ്
the baby has very fine hair##person,tennis racket,person,person,person,person	കുഞ്ഞിന് വളരെ നേർത്ത മുടിയുണ്ട്
Top window pane in the left corner of the second story window##person,tennis racket,person,person,person,person,person,person,person,chair	രണ്ടാമത്തെ സ്റ്റോറി വിൻഡോയുടെ ഇടത് കോണിലുള്ള മുകളിലെ വിൻഡോ പാളി
a fast food meal served on a white plate##person,sports ball,chair,baseball bat	ഒരു വെളുത്ത പാത്രത്തിൽ വിളമ്പിയിരിക്കുന്ന ഒരു ഫാസ്റ്റ് ഫുഡ് ഭക്ഷണം
three baseball players playing a game##person,person,baseball bat,sports ball,baseball bat,person,baseball glove,baseball bat,baseball glove	മൂന്ന് ബേസ്ബോൾ കളിക്കാർ ഒരു ഗെയിം കളിക്കുന്നു
expiration date in black ink##sink,sink	കാലഹരണപ്പെടുന്ന തീയതി കറുത്ത മഷിയിൽ
Sponsor signs hanging on the walls of the tennis court.##train,clock,suitcase,train	ടെന്നീസ് കോർട്ടിന്റെ ചുമരുകളിൽ സ്പോൺസറിന്റെ പേര് തൂക്കിയിരിക്കുന്നു
players in the dugout.##person,person,person,baseball glove,person,person,person,person,person,person	ഡഗഔട്ടിലെ കളിക്കാർ.
a tea set on a wooden stand##person,person,tennis racket,sports ball,person,person,person,person,person,person	ഒരു വുഡൻ സ്റ്റാൻഡിൽ ഒരു ചായ സെറ്റ്
the copyright stamp on the photo##chair,oven,bottle,chair,sink,bottle,dining table,bottle,bottle,potted plant	ഫോട്ടോയിലെ പകർപ്പവകാശ സ്റ്റാമ്പ്
date and time stamp on a picture##apple,apple,apple,dining table,apple,apple,bowl,orange,bowl,orange	ഒരു ചിത്രത്തിലെ തീയതിയും സമയ സ്റ്റാമ്പും
5 cars of varying models parked on the street##person,tennis racket,baseball glove	വ്യത്യസ്ത മോഡലു ൾ ഉള്ള അഞ്ച് കാറുകൾ തെരുവിൽ പാർക്ക് ചെയ്തിരിക്കുന്നു
Red dragon fruit on a fruit stand.##suitcase,person,cup,skateboard,fire hydrant,knife	ഫ്രൂട്ട് സ്റ്റാൻഡിൽ ഒരു ചുവന്ന ഡ്രാഗൺ ഫ്രൂട്ട്.
baseball players helmet##person,tennis racket	ബേസ്ബോൾ കളിക്കാരുടെ ഹെൽമെറ്റ്
a white sign not in English##bottle,bottle,bottle,bottle,bottle,vase,vase,bottle,bottle,wine glass	ഇംഗ്ലീഷിൽ അല്ലാത്ത ഒരു വെളുത്ത ചിഹ്നം
boy sitting cross-legged on ground##person,person,person,person,tennis racket,person,person,person,person,handbag	കുട്ടി നിലത്ത് ക്രോസ്സ്-ലെഗ്ഡ് ആയി ഇരിക്കുന്നു
a white paper not in english##car,umbrella,car,stop sign,car,car,stop sign,car,car	ഇംഗ്ലീഷിലില്ലാത്ത ഒരു വെളുത്ത പത്രം
baseball players posing together in an old photograph##motorcycle,tie,person	ഒരു പഴയ ഫോട്ടോഗ്രാഫിൽ ബേസ്ബോൾ കളിക്കാർ ഒരുമിച്ച് പോസ് ചെയ്യുന്നു
black springs##person,skateboard	കറുത്ത സ്പ്രിങ്ങുകൾ
red and white cross on man's shoulder##person,book	മനുഷ്യന്റെ തോളിൽ ചുവപ്പും വെള്ളയും കുരിശ്
Three different cellphone models##person,bowl,bowl,bowl,cup,person,person,bottle,cup,person	മൂന്ന് വ്യത്യസ്ത സെൽഫോൺ മോഡലുകൾ
The second clock showing on the tower.##bed,potted plant,potted plant,bench,vase,chair,vase,vase	ടവറിൽ കാണുന്ന രണ്ടാമത്തെ ക്ലോക്ക്.
cross walk at intersection##person,chair,dining table,donut,book,backpack,suitcase,handbag,book,chair	കവലയിൽ സീബ്ര ക്രോസ്സ് വര
white springs boxes and gears below train engine##sink,bottle	ട്രെയിൻ എഞ്ചിന് താഴെ വൈറ്റ് സ്പ്രിംഗ് ബോക്സുകളും ഗിയറുകളും
the court is dark blue##bowl,chair,couch,dining table,book,tv,book,book,book,book	കോർട്ട് ഇരുണ്ട നീല നിറമാണ്
A crowd of people standing at the fair.##person,train,bicycle,bus,car,person,person,train,train,bus	മേളയിൽ ഒരു കൂട്ടം ആളുകൾ നിൽക്കുന്നു.
cross centered in curved panels##skateboard,person,person,person,tv,chair,skateboard,person,skateboard,bench	വളഞ്ഞ പാനലുകളിൽ കേന്ദ്രീകരിച്ചിരിക്കുന്നു ക്രോസ്
Net across tennis court##person,person,potted plant,chair,chair,remote,remote,remote,person,chair	ടെന്നീസ് കോർട്ടിൽ കുറുകെ കുറുകെ വല
man standing next to fruit stand##chair,tv,bowl,dining table,chair,dining table,couch,dining table,bottle,vase	ഫ്രൂട്ട് സ്റ്റാൻഡിന് സമീപം നിൽക്കുന്ന മനുഷ്യൻ
Several models hanging in the air in the exhibit##orange,orange,orange,orange,orange,orange,orange,orange,orange,orange	എക്സിബിറ്റിൽ നിരവധി മോഡലുകൾ വായുവിൽ തൂങ്ങിക്കിടക്കുന്നു
A white plate with english muffins##couch,tv,chair,vase,potted plant,chair,dining table,chair,clock,dining table	ഇംഗ്ലീഷ് മഫിനുകളുള്ള ഒരു വെളുത്ത പ്ലേറ്റ്
Large blue flag above the entire fair##person,skis,person,person,backpack,person,snowboard	മുഴുവൻ മേളയ്ക്കും മുകളിൽ വലിയ നീല പതാക
yellow date taken stamp##vase,chair,potted plant,vase,tv,laptop,laptop,chair,tv	മഞ്ഞ തീയതിയുള്ള സ്റ്റാമ്പ്
cross walk area painted on the street##banana,banana,surfboard,banana,banana,banana,banana	തെരുവിൽ വരച്ച ക്രോസ് വാക്ക് സ്ഥലം
floral box springs under mattress##keyboard,laptop,tv,keyboard,cup,mouse,person,book,keyboard,handbag	കട്ടിൽ കീഴിലുള്ള പുഷ്പ ബോക്സ് സ്പ്രിങ്ങ്സ്
person on the court wearing black shirt##tv,tv,mouse,potted plant,book,person,keyboard,book,book,book	കറുത്ത ഷർട്ട് ധരിച്ച കോർട്ടിൽ ഒരാൾ
a sandwich on a block##	ഒരു ബ്ലോക്കിലെ സാൻഡ്‌വിച്ച്
a platter of fine china##toilet	ഫൈൻ ചൈനയുടെ ഒരു തളിക
Four players standing on a tennis court##person,tennis racket,person,person,person,tennis racket,person,tennis racket,sports ball,bench	നാല് കളിക്കാർ ഒരു ടെന്നീസ് കോർട്ടിൽ നിൽക്കുന്നു
A large brown block.##person,person,motorcycle,motorcycle,motorcycle,chair,motorcycle	ഒരു വലിയ തവിട്ട് ബ്ലോക്ക്.
wooden sign with white letters on second bus##person,tennis racket,sports ball	രണ്ടാമത്തെ ബസ്സിൽ വെളുത്ത അക്ഷരങ്ങളുള്ള തടി ചിഹ്നം
lighted signs for different forms of public transportation##person,person,baseball bat,person,person,baseball bat,baseball bat,person,person,person	വിവിധ തരത്തിലുള്ള പൊതുഗതാഗതത്തിനായി പ്രകാശമുള്ള അടയാളങ്ങൾ
Woman dressed as a maiden at the fair##person,tennis racket	മേളയിൽ കന്യകയായി വേഷം ധരിച്ച സ്ത്രീ
March 7th is the date on the calendar##motorcycle,chair,person	മാർച്ച് 7 കലണ്ടറിലെ തീയതിയാണ്
person holding a block of ice##person,surfboard,surfboard	ഐസ് ബ്ലോക്ക് കൈവശമുള്ള വ്യക്തി
English city bus on the road##person,person,tennis racket,person,person,person,person,person,person,person	റോഡിൽ ഇംഗ്ലീഷ് സിറ്റി ബസ്
